Année;Code_Département;Nom_Département;E_Total;H_Total;F_Total;E_0_19_ans;E_20_39_ans;E_40_59_ans;E_60_74_ans;E_75_et_plus
1975;01;Ain;121326;62258;59068;105393;80174;50440;18944;376277
1975;02;Aisne;189403;96864;92539;138789;111665;67810;26772;534439
1975;03;Allier;110715;56503;54212;88944;87630;65152;26731;379172
1975;04;Alpes-de-Haute-Provence;33382;17261;16121;28024;25479;18096;7187;112168
1975;05;Hautes-Alpes;29358;15192;14166;25633;22261;14607;5548;97407
1975;06;Alpes-Maritimes;197624;101103;96521;203840;191754;156743;65877;815838
1975;07;Ardèche;78835;40414;38421;61923;57910;41938;16813;257419
1975;08;Ardennes;113152;58028;55124;80149;64037;38213;14253;309804
1975;09;Ariège;36789;18955;17834;29820;32673;27061;11750;138093
1975;10;Aube;93256;47750;45506;77161;59206;39402;16037;285062
1975;11;Aude;74269;38511;35758;59132;66494;51217;21803;272915
1975;12;Aveyron;80108;40930;39178;64215;64673;50387;19461;278844
1975;13;Bouches-du-Rhône;498687;255450;243237;461172;379815;212023;80285;1631982
1975;14;Calvados;201930;102911;99019;156051;115317;64596;22984;560878
1975;15;Cantal;52254;26618;25636;38935;37733;27456;10449;166827
1975;16;Charente;106304;54283;52021;82492;75695;52303;20747;337541
1975;17;Charente-Maritime;159736;81645;78091;120052;110162;77386;30861;498197
1975;18;Cher;96819;49578;47241;79607;67958;51242;20905;316531
1975;19;Corrèze;65736;33887;31849;55397;57414;44578;17594;240719
1975;21;Côte-d'Or;152744;77611;75133;129532;93736;56806;23116;455934
1975;22;Côtes-d'Armor;171225;88060;83165;123884;118924;84317;27582;525932
1975;23;Creuse;37336;19055;18281;29157;34721;31477;13957;146648
1975;24;Dordogne;104758;53896;50862;83379;90130;68923;26519;373709
1975;25;Doubs;169941;86139;83802;142505;93656;48392;16193;470687
1975;26;Drôme;117450;60482;56968;95717;78976;50268;19565;361976
1975;27;Eure;150442;76759;73683;115061;86536;51537;19143;422719
1975;28;Eure-et-Loir;114101;58856;55245;90619;68291;44800;17120;334931
1975;29;Finistère;260202;132913;127289;194883;183601;124761;41033;804480
1975;2A;Corse-du-Sud;26285;13693;12592;28470;24259;16033;6449;101496
1975;2B;Haute-Corse;31733;16658;15075;37729;29082;19032;7919;125495
1975;30;Gard;149043;76309;72734;123704;116715;75219;30220;494901
1975;31;Haute-Garonne;232570;118561;114009;227477;175178;101889;39905;777019
1975;32;Gers;49622;25369;24253;39862;42233;31562;12404;175683
1975;33;Gironde;322031;164007;158024;287901;239378;148563;63822;1061695
1975;34;Hérault;189455;96710;92745;170698;146891;99614;41369;648027
1975;35;Ille-et-Vilaine;242665;123120;119545;192374;148859;89194;28936;702028
1975;36;Indre;74486;38402;36084;57839;55047;43433;18123;248928
1975;37;Indre-et-Loire;159991;81397;78594;129112;98213;64300;26770;478386
1975;38;Isère;285686;146270;139416;254694;183930;98810;36593;859713
1975;39;Jura;78776;40472;38304;60164;51661;35444;13144;239189
1975;40;Landes;86747;44483;42264;69123;66152;47767;18771;288560
1975;41;Loir-et-Cher;90903;46571;44332;70171;59018;44954;18708;283754
1975;42;Loire;238284;121397;116887;199132;166717;101111;37764;743008
1975;43;Haute-Loire;62124;31829;30295;48235;45955;35142;14419;205875
1975;44;Loire-Atlantique;330125;168659;161466;253938;197702;110691;41610;934066
1975;45;Loiret;159056;81203;77853;137626;100915;65830;26277;489704
1975;46;Lot;42293;21729;20564;33984;35153;28507;10988;150925
1975;47;Lot-et-Garonne;86677;44190;42487;70042;68860;48341;19088;293008
1975;48;Lozère;22101;11347;10754;17741;16432;13122;5536;74932
1975;49;Maine-et-Loire;231299;117562;113737;164702;125159;77123;31510;629793
1975;50;Manche;157424;80226;77198;108078;102407;63793;20533;452235
1975;51;Marne;185956;94661;91295;155775;104993;60063;23333;530120
1975;52;Haute-Marne;75943;38992;36951;54722;43631;27674;10694;212664
1975;53;Mayenne;92082;46916;45166;65473;56190;36007;12201;261953
1975;54;Meurthe-et-Moselle;248294;125891;122403;209541;153401;83022;28744;723002
1975;55;Meuse;70538;36196;34342;51317;43037;28308;11101;204301
1975;56;Morbihan;194284;99776;94508;137967;125726;80896;25066;563939
1975;57;Moselle;369706;188655;181051;285466;217769;102809;31017;1006767
1975;58;Nièvre;73028;37564;35464;56735;53417;43502;18984;245666
1975;59;Nord;907224;462025;445199;685592;519103;295226;104447;2511592
1975;60;Oise;218006;111582;106424;175662;119508;66292;26344;605812
1975;61;Orne;102911;52558;50353;73151;63716;39661;14384;293823
1975;62;Pas-de-Calais;515294;262767;252527;356535;304216;172702;56122;1404869
1975;63;Puy-de-Dôme;179585;91501;88084;162332;129753;78723;29725;580118
1975;64;Pyrénées-Atlantiques;165470;84271;81199;132164;122067;83227;32133;535061
1975;65;Hautes-Pyrénées;66688;34244;32444;55175;55043;36865;13735;227506
1975;66;Pyrénées-Orientales;83423;42778;40645;65784;74197;55528;20769;299701
1975;67;Bas-Rhin;295873;150241;145632;252985;182862;114014;36440;882174
1975;68;Haut-Rhin;211846;108194;103652;182154;134658;79061;27192;634911
1975;69;Rhône;462087;235326;226761;431570;310785;164659;59945;1429046
1975;70;Haute-Saône;75564;38731;36833;55909;45338;32965;12677;222453
1975;71;Saône-et-Loire;182510;93234;89276;141372;125961;86022;34351;570216
1975;72;Sarthe;173980;89069;84911;124984;101575;65032;24912;490483
1975;73;Savoie;98998;50616;48382;85353;67472;39057;14180;305060
1975;74;Haute-Savoie;148246;75960;72286;139236;93560;49443;16403;446888
1975;75;Paris;458722;230498;228224;762672;550947;386087;150646;2309074
1975;76;Seine-Maritime;412590;210176;202414;329013;246263;136481;48582;1172929
1975;77;Seine-et-Marne;261396;133619;127777;224147;151438;82871;33337;753189
1975;78;Yvelines;376058;192959;183099;346981;230577;89114;35565;1078295
1975;79;Deux-Sèvres;113349;58131;55218;81961;71645;49388;19696;336039
1975;80;Somme;191111;97128;93983;140848;108339;70701;27580;538579
1975;81;Tarn;99571;51308;48263;79984;80813;55746;22206;338320
1975;82;Tarn-et-Garonne;54987;28254;26733;43003;42497;31227;11885;183599
1975;83;Var;177906;91922;85984;161265;147474;102459;36721;625825
1975;84;Vaucluse;122131;62829;59302;105930;87483;54485;20231;390260
1975;85;Vendée;157381;80353;77028;111003;93494;64995;23723;450596
1975;86;Vienne;116272;59112;57160;91610;75059;53141;21368;357450
1975;87;Haute-Vienne;95600;48693;46907;88075;81975;61375;25430;352455
1975;88;Vosges;137125;70114;67011;103337;82930;55758;19249;398399
1975;89;Yonne;92321;47322;44999;73023;61242;51466;21880;299932
1975;90;Territoire de Belfort;43203;22342;20861;37061;27561;14937;5518;128280
1975;91;Essonne;327410;167672;159738;300427;188033;71921;30786;918577
1975;92;Hauts-de-Seine;393070;199382;193688;459849;355374;169242;62521;1440056
1975;93;Seine-Saint-Denis;430126;221012;209114;415769;305681;125445;44444;1321465
1975;94;Val-de-Marne;369928;186977;182951;386828;282023;124410;51523;1214712
1975;95;Val-d'Oise;293014;149608;143406;262872;181391;72473;28545;838295
1976;01;Ain;122612;62965;59647;107766;82110;49288;19550;381326
1976;02;Aisne;187288;95844;91444;140637;113284;65871;27190;534270
1976;03;Allier;109220;55811;53409;89475;88409;63329;27212;377645
1976;04;Alpes-de-Haute-Provence;33348;17262;16086;28475;25889;17884;7379;112975
1976;05;Hautes-Alpes;29350;15174;14176;26341;22567;14378;5713;98349
1976;06;Alpes-Maritimes;198120;101572;96548;206887;194247;155850;68432;823536
1976;07;Ardèche;78603;40351;38252;63101;58685;40930;17241;258560
1976;08;Ardennes;111481;57107;54374;80629;64981;36975;14429;308495
1976;09;Ariège;36214;18633;17581;30182;32860;26302;11987;137545
1976;10;Aube;92604;47475;45129;78119;60167;38301;16498;285689
1976;11;Aude;74076;38446;35630;60227;66924;50255;22239;273721
1976;12;Aveyron;79175;40453;38722;64821;65382;49383;19908;278669
1976;13;Bouches-du-Rhône;498110;255032;243078;467982;384871;210191;82652;1643806
1976;14;Calvados;200917;102471;98446;158850;117632;63453;23642;564494
1976;15;Cantal;51500;26294;25206;39288;37994;26855;10669;166306
1976;16;Charente;105119;53667;51452;83525;76683;51300;21225;337852
1976;17;Charente-Maritime;158299;80996;77303;121901;112052;76321;31483;500056
1976;18;Cher;96167;49084;47083;80560;69118;49854;21325;317024
1976;19;Corrèze;65125;33598;31527;56006;57880;43753;17980;240744
1976;21;Côte-d'Or;152138;77351;74787;131420;95294;55713;23615;458180
1976;22;Côtes-d'Armor;170346;87635;82711;125331;120682;82844;28405;527608
1976;23;Creuse;36750;18742;18008;29355;34829;30493;14203;145630
1976;24;Dordogne;103728;53306;50422;84375;90882;67710;27176;373871
1976;25;Doubs;168595;85576;83019;143149;95412;47454;16771;471381
1976;26;Drôme;117531;60516;57015;97444;80669;49357;20150;365151
1976;27;Eure;150933;77012;73921;117979;88545;50539;19743;427739
1976;28;Eure-et-Loir;114375;59004;55371;92471;69891;43989;17646;338372
1976;29;Finistère;259128;132453;126675;197893;185715;122621;42089;807446
1976;2A;Corse-du-Sud;26468;13726;12742;28844;24345;16126;6567;102350
1976;2B;Haute-Corse;32054;16745;15309;37628;29673;18736;8169;126260
1976;30;Gard;149079;76288;72791;126516;118620;74024;31040;499279
1976;31;Haute-Garonne;232473;118770;113703;231212;177770;100626;41042;783123
1976;32;Gers;49015;25098;23917;40238;42601;31089;12653;175596
1976;33;Gironde;322301;164180;158121;294227;242452;145774;64926;1069680
1976;34;Hérault;189962;97000;92962;174535;149385;98414;42553;654849
1976;35;Ille-et-Vilaine;243684;123694;119990;196072;151488;87787;29601;708632
1976;36;Indre;73357;37688;35669;58253;55603;42337;18525;248075
1976;37;Indre-et-Loire;159424;81011;78413;131685;100289;63445;27369;482212
1976;38;Isère;286795;146867;139928;259986;187688;97154;37731;869354
1976;39;Jura;78438;40314;38124;60787;52373;34545;13509;239652
1976;40;Landes;86163;44184;41979;69930;67226;46971;19277;289567
1976;41;Loir-et-Cher;90544;46442;44102;71285;60313;44086;19229;285457
1976;42;Loire;236812;120740;116072;199731;168440;98354;38747;742084
1976;43;Haute-Loire;61630;31614;30016;48841;46531;34026;14743;205771
1976;44;Loire-Atlantique;330436;168940;161496;258855;201340;109065;42449;942145
1976;45;Loiret;159884;81763;78121;140381;103672;64733;26840;495510
1976;46;Lot;41941;21483;20458;34515;35475;28058;11270;151259
1976;47;Lot-et-Garonne;85895;43783;42112;70821;69636;47751;19476;293579
1976;48;Lozère;21816;11240;10576;18058;16472;12832;5575;74753
1976;49;Maine-et-Loire;231954;117876;114078;168410;127613;75760;32140;635877
1976;50;Manche;156287;79566;76721;109856;104185;62521;21162;454011
1976;51;Marne;184656;94069;90587;157788;106818;58611;23826;531699
1976;52;Haute-Marne;74844;38459;36385;55180;44243;27013;10819;212099
1976;53;Mayenne;92038;46971;45067;66225;57216;35271;12516;263266
1976;54;Meurthe-et-Moselle;245083;124386;120697;210700;155715;80768;29423;721689
1976;55;Meuse;69547;35768;33779;51934;43634;27399;11194;203708
1976;56;Morbihan;194126;99680;94446;140048;127633;79832;25710;567349
1976;57;Moselle;363909;185821;178088;288333;220844;101137;31853;1006076
1976;58;Nièvre;71970;37048;34922;57192;54045;42306;19367;244880
1976;59;Nord;901029;459160;441869;693594;525453;284656;106243;2510975
1976;60;Oise;219243;112319;106924;179464;122723;64569;27008;613007
1976;61;Orne;101907;52060;49847;73865;64788;38668;14821;294049
1976;62;Pas-de-Calais;510811;260652;250159;361682;307918;167566;57464;1405441
1976;63;Puy-de-Dôme;178892;91286;87606;164254;131793;76589;30565;582093
1976;64;Pyrénées-Atlantiques;164611;83833;80778;133686;123826;82261;33175;537559
1976;65;Hautes-Pyrénées;65783;33825;31958;55810;55448;36316;13993;227350
1976;66;Pyrénées-Orientales;84169;43207;40962;67453;75339;55375;21389;303725
1976;67;Bas-Rhin;293475;149089;144386;257566;186142;111362;37670;886215
1976;68;Haut-Rhin;210243;107391;102852;184624;137212;76615;28128;636822
1976;69;Rhône;458833;234025;224808;433284;315861;159996;61920;1429894
1976;70;Haute-Saône;75530;38771;36759;56842;46273;32095;12900;223640
1976;71;Saône-et-Loire;181131;92633;88498;142806;127724;83612;35132;570405
1976;72;Sarthe;173084;88744;84340;126885;103442;63889;25500;492800
1976;73;Savoie;99172;50700;48472;86636;68525;38350;14671;307354
1976;74;Haute-Savoie;149163;76474;72689;141896;95774;48884;17048;452765
1976;75;Paris;448512;225496;223016;769816;545939;369456;152825;2286548
1976;76;Seine-Maritime;408862;208448;200414;333587;249727;133580;49892;1175648
1976;77;Seine-et-Marne;266488;136267;130221;231087;156574;81190;34286;769625
1976;78;Yvelines;378696;194282;184414;352031;238729;87495;36633;1093584
1976;79;Deux-Sèvres;112760;57844;54916;82999;72929;48325;20092;337105
1976;80;Somme;189668;96368;93300;143166;110150;68384;28126;539494
1976;81;Tarn;98572;50785;47787;80738;81668;54452;22873;338303
1976;82;Tarn-et-Garonne;54794;28196;26598;43769;43051;30678;12155;184447
1976;83;Var;179000;92451;86549;164925;150418;103280;37982;635605
1976;84;Vaucluse;122670;63051;59619;107918;89402;54132;20814;394936
1976;85;Vendée;157318;80478;76840;113351;95629;64268;24346;454912
1976;86;Vienne;115661;58800;56861;93363;76337;52099;21915;359375
1976;87;Haute-Vienne;94658;48252;46406;89246;82915;60004;25930;352753
1976;88;Vosges;135584;69353;66231;104272;84225;53958;19859;397898
1976;89;Yonne;92100;47185;44915;74338;62247;50320;22293;301298
1976;90;Territoire de Belfort;43037;22311;20726;37376;28024;14613;5661;128711
1976;91;Essonne;328213;168203;160010;302685;194846;70713;31612;928069
1976;92;Hauts-de-Seine;385732;195617;190115;460137;357007;163532;64118;1430526
1976;93;Seine-Saint-Denis;425978;218998;206980;416837;309860;121322;45700;1319697
1976;94;Val-de-Marne;365512;185249;180263;386771;285216;120551;52345;1210395
1976;95;Val-d'Oise;294883;150692;144191;267373;186497;70684;29597;849034
1977;01;Ain;123830;63529;60301;110580;84889;47456;20452;387207
1977;02;Aisne;184614;94645;89969;142829;115538;63134;27820;533935
1977;03;Allier;107327;54885;52442;90449;89907;60632;27833;376148
1977;04;Alpes-de-Haute-Provence;33275;17209;16066;28963;26692;17375;7640;113945
1977;05;Hautes-Alpes;29358;15176;14182;27084;23031;14031;5929;99433
1977;06;Alpes-Maritimes;198656;101711;96945;210953;199050;153012;70940;832611
1977;07;Ardèche;78188;40238;37950;64550;60198;39233;17807;259976
1977;08;Ardennes;109785;56177;53608;81397;66211;35237;14839;307469
1977;09;Ariège;35637;18320;17317;30656;33526;25136;12286;137241
1977;10;Aube;91822;47104;44718;79137;61313;36854;17083;286209
1977;11;Aude;73524;38193;35331;61735;68186;48225;22938;274608
1977;12;Aveyron;78086;39864;38222;65632;66867;47425;20574;278584
1977;13;Bouches-du-Rhône;497554;254558;242996;475724;392215;205484;85225;1656202
1977;14;Calvados;199622;101903;97719;162165;120419;61501;24601;568308
1977;15;Cantal;50488;25825;24663;39908;38561;25810;10892;165659
1977;16;Charente;103807;53002;50805;84777;78398;49276;22014;338272
1977;17;Charente-Maritime;156168;79951;76217;124392;114966;74036;32359;501921
1977;18;Cher;95237;48459;46778;81560;70816;47917;21821;317351
1977;19;Corrèze;64288;33114;31174;57018;58979;42062;18681;241028
1977;21;Côte-d'Or;151218;76835;74383;133389;97548;53817;24336;460308
1977;22;Côtes-d'Armor;168678;86813;81865;127424;123574;80106;29567;529349
1977;23;Creuse;35986;18423;17563;29661;35456;29012;14512;144627
1977;24;Dordogne;102307;52586;49721;85710;92909;65234;28118;374278
1977;25;Doubs;167102;84815;82287;144159;97718;46071;17477;472527
1977;26;Drôme;117236;60261;56975;99898;82699;47852;20876;368561
1977;27;Eure;151111;77119;73992;121305;91204;49061;20378;433059
1977;28;Eure-et-Loir;114349;58976;55373;94850;71877;42626;18326;342028
1977;29;Finistère;256901;131422;125479;201931;189436;118406;43596;810270
1977;2A;Corse-du-Sud;26650;13691;12959;29292;24803;16025;6570;103340
1977;2B;Haute-Corse;32481;16837;15644;37472;30174;18818;8154;127099
1977;30;Gard;148390;76021;72369;129950;121529;71706;32008;503583
1977;31;Haute-Garonne;231742;118518;113224;235543;182031;98114;42206;789636
1977;32;Gers;48145;24689;23456;40602;43632;29907;13096;175382
1977;33;Gironde;322182;164150;158032;301649;247666;141102;66447;1079046
1977;34;Hérault;190847;97475;93372;179149;153096;95915;43968;662975
1977;35;Ille-et-Vilaine;243590;123857;119733;200164;155713;84739;30608;714814
1977;36;Indre;72033;36860;35173;58950;56651;40693;19062;247389
1977;37;Indre-et-Loire;158610;80575;78035;134391;103179;61613;28317;486110
1977;38;Isère;288228;147693;140535;265333;193005;94491;38953;880010
1977;39;Jura;77678;39878;37800;61733;53514;33090;14066;240081
1977;40;Landes;85367;43858;41509;70997;69162;45316;19936;290778
1977;41;Loir-et-Cher;89910;46124;43786;72597;62191;42577;19959;287234
1977;42;Loire;235012;119835;115177;200858;171334;94272;40070;741546
1977;43;Haute-Loire;60898;31296;29602;49611;47671;32366;15121;205667
1977;44;Loire-Atlantique;330155;168867;161288;264071;207081;105321;43765;950393
1977;45;Loiret;160219;81875;78344;143632;107020;62898;27641;501410
1977;46;Lot;41366;21243;20123;35259;36410;27020;11673;151728
1977;47;Lot-et-Garonne;84839;43256;41583;71940;71086;46160;20116;294141
1977;48;Lozère;21467;11030;10437;18418;16687;12334;5695;74601
1977;49;Maine-et-Loire;231800;117886;113914;172480;131222;72842;33148;641492
1977;50;Manche;154559;78724;75835;111843;106605;60629;21976;455612
1977;51;Marne;183089;93215;89874;159703;109222;56636;24436;533086
1977;52;Haute-Marne;73485;37772;35713;56014;45134;26041;11070;211744
1977;53;Mayenne;91554;46770;44784;67310;58641;33948;12976;264429
1977;54;Meurthe-et-Moselle;241431;122722;118709;212479;158627;77698;30364;720599
1977;55;Meuse;68478;35302;33176;52553;44412;26226;11448;203117
1977;56;Morbihan;192863;99050;93813;142935;131135;77301;26665;570899
1977;57;Moselle;357434;182675;174759;291440;225917;97828;33029;1005648
1977;58;Nièvre;70616;36335;34281;57907;54968;40546;19883;243920
1977;59;Nord;892599;455187;437412;702702;536899;269107;108800;2510107
1977;60;Oise;219928;112827;107101;183745;126564;62194;27849;620280
1977;61;Orne;100345;51263;49082;74967;66177;37172;15393;294054
1977;62;Pas-de-Calais;504152;257250;246902;367902;312963;160983;59182;1405182
1977;63;Puy-de-Dôme;177199;90496;86703;166952;134818;73194;31562;583725
1977;64;Pyrénées-Atlantiques;163159;83066;80093;135898;126912;79904;34509;540382
1977;65;Hautes-Pyrénées;64786;33311;31475;56596;56424;35082;14362;227250
1977;66;Pyrénées-Orientales;84957;43643;41314;69648;77528;54558;22185;308876
1977;67;Bas-Rhin;290434;147611;142823;262928;190745;106657;39346;890110
1977;68;Haut-Rhin;208303;106478;101825;186969;140841;73176;29192;638481
1977;69;Rhône;455860;232486;223374;435749;322003;153758;64167;1431537
1977;70;Haute-Saône;75211;38689;36522;58032;47584;30757;13223;224807
1977;71;Saône-et-Loire;179200;91777;87423;144565;130238;80039;36342;570384
1977;72;Sarthe;171569;88085;83484;129093;105774;61748;26486;494670
1977;73;Savoie;98756;50502;48254;88315;70354;37076;15269;309770
1977;74;Haute-Savoie;150013;76886;73127;144785;98957;47617;17878;459250
1977;75;Paris;442615;222406;220209;773235;546070;349127;156066;2267113
1977;76;Seine-Maritime;404278;206086;198192;338305;254306;129181;51639;1177709
1977;77;Seine-et-Marne;271693;138927;132766;238554;163436;78646;35772;788101
1977;78;Yvelines;381001;195365;185636;357830;247740;84985;37879;1109435
1977;79;Deux-Sèvres;111545;57251;54294;84380;74897;46538;20592;337952
1977;80;Somme;187895;95375;92520;145573;112446;65526;28809;540249
1977;81;Tarn;97346;50249;47097;81756;83566;52165;23688;338521
1977;82;Tarn-et-Garonne;54442;27980;26462;44779;44036;29596;12588;185441
1977;83;Var;180050;93002;87048;169816;155261;102534;39638;647299
1977;84;Vaucluse;122953;63141;59812;110467;92144;52788;21667;400019
1977;85;Vendée;156802;80249;76553;116176;98764;62292;25211;459245
1977;86;Vienne;114549;58213;56336;95329;78287;50373;22575;361113
1977;87;Haute-Vienne;93788;47741;46047;90784;84405;57535;26804;353316
1977;88;Vosges;133784;68413;65371;105466;85790;51977;20479;397496
1977;89;Yonne;91582;46911;44671;75741;63963;48393;23033;302712
1977;90;Territoire de Belfort;42690;22057;20633;37967;28594;14098;5864;129213
1977;91;Essonne;328752;168531;160221;304601;202921;68384;32835;937493
1977;92;Hauts-de-Seine;379923;192751;187172;460017;360581;156068;66475;1423064
1977;93;Seine-Saint-Denis;422602;216820;205782;418904;314528;115910;47178;1319122
1977;94;Val-de-Marne;361228;183320;177908;387167;289346;115615;53857;1207213
1977;95;Val-d'Oise;296326;151473;144853;272059;192269;68280;30757;859691
1978;01;Ain;124878;64021;60857;113543;87314;45970;21275;392980
1978;02;Aisne;182190;93507;88683;144921;117828;60262;28718;533919
1978;03;Allier;105538;54043;51495;91426;91097;58082;28665;374808
1978;04;Alpes-de-Haute-Provence;33085;17150;15935;29659;27352;16899;7932;114927
1978;05;Hautes-Alpes;29305;15197;14108;27929;23512;13661;6165;100572
1978;06;Alpes-Maritimes;198767;101551;97216;215533;203837;149758;73982;841877
1978;07;Ardèche;77531;39982;37549;66182;61536;37742;18449;261440
1978;08;Ardennes;108122;55322;52800;82231;67497;33542;15282;306674
1978;09;Ariège;35042;18019;17023;31187;34040;24029;12600;136898
1978;10;Aube;90848;46648;44200;80292;62371;35527;17696;286734
1978;11;Aude;72908;37949;34959;63562;69234;46441;23638;275783
1978;12;Aveyron;76931;39277;37654;66775;67894;45631;21363;278594
1978;13;Bouches-du-Rhône;497624;254854;242770;484077;398242;201293;88281;1669517
1978;14;Calvados;198477;101329;97148;165310;123025;59975;25508;572295
1978;15;Cantal;49578;25390;24188;40482;39162;24870;11215;165307
1978;16;Charente;102358;52248;50110;86442;79787;47512;22866;338965
1978;17;Charente-Maritime;154135;78988;75147;127196;117235;71902;33613;504081
1978;18;Cher;94280;47984;46296;82780;72124;46160;22487;317831
1978;19;Corrèze;63377;32580;30797;58144;59788;40616;19290;241215
1978;21;Côte-d'Or;150768;76520;74248;135456;99485;52126;25183;463018
1978;22;Côtes-d'Armor;166846;85887;80959;129665;126275;77551;30903;531240
1978;23;Creuse;35205;18027;17178;30091;35967;27728;14822;143813
1978;24;Dordogne;100747;51825;48922;87546;94386;63111;29181;374971
1978;25;Doubs;165980;84287;81693;144648;99733;44981;18199;473541
1978;26;Drôme;117074;60204;56870;102243;84854;46565;21597;372333
1978;27;Eure;151030;77061;73969;124857;93606;47723;21157;438373
1978;28;Eure-et-Loir;114380;58975;55405;97277;73853;41477;19055;346042
1978;29;Finistère;254842;130507;124335;206449;192704;114723;45193;813911
1978;2A;Corse-du-Sud;26971;13819;13152;29723;24977;15861;6801;104333
1978;2B;Haute-Corse;32911;17032;15879;37551;30654;18525;8381;128022
1978;30;Gard;147681;75710;71971;133778;123893;69722;33265;508339
1978;31;Haute-Garonne;232147;118425;113722;239424;185631;95628;43683;796513
1978;32;Gers;47302;24352;22950;41205;44358;28727;13627;175219
1978;33;Gironde;322132;164084;158048;309027;251901;136800;68495;1088355
1978;34;Hérault;192112;97905;94207;183396;156383;93845;45354;671090
1978;35;Ille-et-Vilaine;243871;124092;119779;203914;159737;82071;31880;721473
1978;36;Indre;70591;36069;34522;59884;57526;39080;19673;246754
1978;37;Indre-et-Loire;158044;80239;77805;136718;105859;60051;29333;490005
1978;38;Isère;289530;148322;141208;270550;198086;91886;40503;890555
1978;39;Jura;76799;39454;37345;62841;54458;31923;14561;240582
1978;40;Landes;84334;43358;40976;72551;70666;43793;20783;292127
1978;41;Loir-et-Cher;89095;45719;43376;74226;63844;41304;20714;289183
1978;42;Loire;233135;118866;114269;202231;173650;90806;41494;741316
1978;43;Haute-Loire;60262;31010;29252;50510;48735;30783;15582;205872
1978;44;Loire-Atlantique;329803;168863;160940;269600;212170;102256;45152;958981
1978;45;Loiret;161038;82137;78901;146962;110184;61129;28686;507999
1978;46;Lot;40868;21034;19834;36005;37296;26009;12142;152320
1978;47;Lot-et-Garonne;83699;42780;40919;73335;72294;44775;20780;294883
1978;48;Lozère;21158;10850;10308;18693;16961;11831;5853;74496
1978;49;Maine-et-Loire;232158;118015;114143;176416;134680;70448;34206;647908
1978;50;Manche;152542;77788;74754;114184;108799;58966;22848;457339
1978;51;Marne;181938;92679;89259;161523;111523;54625;25308;534917
1978;52;Haute-Marne;72378;37241;35137;56619;46063;24965;11518;211543
1978;53;Mayenne;90805;46425;44380;68752;60022;32812;13505;265896
1978;54;Meurthe-et-Moselle;238508;121429;117079;213727;161722;74641;31480;720078
1978;55;Meuse;67306;34709;32597;53242;45177;25124;11715;202564
1978;56;Morbihan;191340;98282;93058;146117;134164;75251;27683;574555
1978;57;Moselle;351149;179620;171529;294975;231074;94364;34321;1005883
1978;58;Nièvre;69335;35692;33643;58675;55791;38992;20474;243267
1978;59;Nord;885293;451593;433700;711195;548094;254636;111758;2510976
1978;60;Oise;220658;113125;107533;188094;130304;60197;28850;628103
1978;61;Orne;98916;50563;48353;76011;67575;36013;15905;294420
1978;62;Pas-de-Calais;498095;254313;243782;374440;317568;155010;61262;1406375
1978;63;Puy-de-Dôme;176002;89841;86161;169289;137520;70281;32607;585699
1978;64;Pyrénées-Atlantiques;161562;82313;79249;138554;129438;77943;35976;543473
1978;65;Hautes-Pyrénées;63749;32776;30973;57582;57095;33964;14912;227302
1978;66;Pyrénées-Orientales;85529;43942;41587;72087;79379;53940;22996;313931
1978;67;Bas-Rhin;288154;146318;141836;267429;196095;101974;41085;894737
1978;68;Haut-Rhin;206383;105600;100783;189919;144369;69705;30215;640591
1978;69;Rhône;453586;231218;222368;437560;327610;148790;66358;1433904
1978;70;Haute-Saône;74843;38532;36311;59387;48724;29522;13637;226113
1978;71;Saône-et-Loire;177036;90712;86324;146507;132743;76972;37523;570781
1978;72;Sarthe;169597;87115;82482;131491;108167;59954;27479;496688
1978;73;Savoie;98511;50370;48141;90206;71825;36053;15880;312475
1978;74;Haute-Savoie;150868;77312;73556;147883;101804;46673;18671;465899
1978;75;Paris;440725;221470;219255;773609;544489;330993;159828;2249644
1978;76;Seine-Maritime;400092;204089;196003;343181;258287;125465;53647;1180672
1978;77;Seine-et-Marne;276859;141523;135336;246244;170199;76474;37382;807158
1978;78;Yvelines;384250;196998;187252;363381;256670;82765;39413;1126479
1978;79;Deux-Sèvres;110382;56763;53619;85998;76491;44863;21330;339064
1978;80;Somme;186167;94587;91580;147930;114403;62983;29764;541247
1978;81;Tarn;96106;49681;46425;82947;85091;49982;24665;338791
1978;82;Tarn-et-Garonne;53971;27728;26243;45910;44986;28637;13049;186553
1978;83;Var;180976;93502;87474;175243;159605;101861;41456;659141
1978;84;Vaucluse;123124;63302;59822;113296;94525;51571;22581;405097
1978;85;Vendée;156318;80034;76284;119149;101758;60248;26314;463787
1978;86;Vienne;113829;57872;55957;97238;80027;48668;23441;363203
1978;87;Haute-Vienne;92916;47319;45597;92192;85654;55321;27717;353800
1978;88;Vosges;132020;67589;64431;106534;87582;49877;21273;397286
1978;89;Yonne;91101;46760;44341;77261;65532;46528;23930;304352
1978;90;Territoire de Belfort;42577;21985;20592;38407;29173;13580;6109;129846
1978;91;Essonne;329154;168741;160413;307258;210586;66607;34164;947769
1978;92;Hauts-de-Seine;375357;190237;185120;459542;362760;150028;68556;1416243
1978;93;Seine-Saint-Denis;419755;215253;204502;421494;318089;111441;48977;1319756
1978;94;Val-de-Marne;357514;181508;176006;387747;292686;111214;55499;1204660
1978;95;Val-d'Oise;297971;152492;145479;277552;197784;65995;32223;871525
1979;01;Ain;125921;64606;61315;116298;89428;44775;21921;398343
1979;02;Aisne;179522;92192;87330;146981;119771;57905;29217;533396
1979;03;Allier;103925;53221;50704;92349;92007;55921;29330;373532
1979;04;Alpes-de-Haute-Provence;32723;17014;15709;30387;27952;16590;8129;115781
1979;05;Hautes-Alpes;29245;15216;14029;28702;23940;13426;6351;101664
1979;06;Alpes-Maritimes;199772;101844;97928;219241;208259;147020;76315;850607
1979;07;Ardèche;77107;39784;37323;67712;62528;36598;18913;262858
1979;08;Ardennes;106238;54409;51829;82836;68674;32023;15581;305352
1979;09;Ariège;34478;17717;16761;31734;34272;23225;12826;136535
1979;10;Aube;89951;46252;43699;81362;63275;34487;18163;287238
1979;11;Aude;72202;37617;34585;65496;69645;45004;24231;276578
1979;12;Aveyron;76041;38899;37142;67587;68706;44231;21938;278503
1979;13;Bouches-du-Rhône;497491;254834;242657;491988;403472;198627;90570;1682148
1979;14;Calvados;197346;100781;96565;168494;124994;58775;26457;576066
1979;15;Cantal;48559;24841;23718;40964;39511;24121;11479;164634
1979;16;Charente;100608;51361;49247;88251;80744;46111;23625;339339
1979;17;Charente-Maritime;152152;77935;74217;129881;118917;70505;34541;505996
1979;18;Cher;93176;47469;45707;84037;73069;44846;22970;318098
1979;19;Corrèze;62439;32141;30298;59050;60443;39390;19849;241171
1979;21;Côte-d'Or;150045;76047;73998;137432;101190;50761;25947;465375
1979;22;Côtes-d'Armor;165004;84968;80036;132069;127946;75669;32191;532879
1979;23;Creuse;34369;17589;16780;30644;36148;26428;15225;142814
1979;24;Dordogne;99249;51114;48135;89150;95319;61551;30039;375308
1979;25;Doubs;164242;83416;80826;145248;101528;44032;18856;473906
1979;26;Drôme;117019;60195;56824;104570;86746;45492;22240;376067
1979;27;Eure;151150;77211;73939;128251;95728;46744;21800;443673
1979;28;Eure-et-Loir;114389;58984;55405;99567;75506;40697;19595;349754
1979;29;Finistère;252865;129612;123253;210571;194934;111965;46691;817026
1979;2A;Corse-du-Sud;27181;13810;13371;29976;25429;15647;6858;105091
1979;2B;Haute-Corse;33157;17169;15988;37482;31370;18208;8497;128714
1979;30;Gard;147215;75615;71600;137319;125584;68504;34191;512813
1979;31;Haute-Garonne;232252;118360;113892;243279;188341;93823;44911;802606
1979;32;Gers;46243;23820;22423;41844;45019;27762;14032;174900
1979;33;Gironde;321774;163855;157919;316123;255257;133573;70149;1096876
1979;34;Hérault;193087;98215;94872;187576;159011;92411;46368;678453
1979;35;Ille-et-Vilaine;243878;124076;119802;207939;162770;80049;33235;727871
1979;36;Indre;69331;35476;33855;60485;58117;37865;20106;245904
1979;37;Indre-et-Loire;157468;79785;77683;139079;108109;58777;30221;493654
1979;38;Isère;290953;149118;141835;275420;202794;89750;41740;900657
1979;39;Jura;75896;38922;36974;63739;55246;31019;14982;240882
1979;40;Landes;83308;42873;40435;73837;72060;42615;21407;293227
1979;41;Loir-et-Cher;88397;45419;42978;75546;65303;40297;21310;290853
1979;42;Loire;230865;117793;113072;203396;175484;87967;42588;740300
1979;43;Haute-Loire;59633;30654;28979;51297;49422;29514;15922;205788
1979;44;Loire-Atlantique;329155;168626;160529;275074;216711;99680;46632;967252
1979;45;Loiret;161451;82293;79158;150320;112904;59744;29525;513944
1979;46;Lot;40256;20692;19564;36781;37936;25168;12528;152669
1979;47;Lot-et-Garonne;82677;42195;40482;74701;73220;43641;21296;295535
1979;48;Lozère;20893;10719;10174;19023;17123;11461;5960;74460
1979;49;Maine-et-Loire;232195;118238;113957;180203;137641;68618;35143;653800
1979;50;Manche;150551;76865;73686;116904;110223;57648;23838;459164
1979;51;Marne;180835;92111;88724;163183;113621;53022;25922;536583
1979;52;Haute-Marne;71177;36637;34540;57338;46655;24282;11738;211190
1979;53;Mayenne;90235;46201;44034;70001;61004;31876;14081;267197
1979;54;Meurthe-et-Moselle;235525;119982;115543;214377;164345;71995;32398;718640
1979;55;Meuse;66057;34157;31900;53830;45918;24093;11964;201862
1979;56;Morbihan;189978;97691;92287;149789;136271;73649;28842;578529
1979;57;Moselle;344382;176201;168181;298086;235740;91370;35442;1005020
1979;58;Nièvre;67904;34939;32965;59382;56534;37626;20841;242287
1979;59;Nord;877765;447852;429913;718680;556944;242242;114287;2509918
1979;60;Oise;221212;113479;107733;192312;133799;58464;29626;635413
1979;61;Orne;97529;49842;47687;77032;68404;35054;16465;294484
1979;62;Pas-de-Calais;491436;250911;240525;380831;320333;150681;62992;1406273
1979;63;Puy-de-Dôme;175362;89479;85883;171263;139672;68109;33343;587749
1979;64;Pyrénées-Atlantiques;159561;81259;78302;141372;131531;76351;37225;546040
1979;65;Hautes-Pyrénées;62684;32283;30401;58514;57588;33054;15369;227209
1979;66;Pyrénées-Orientales;85839;44213;41626;74551;80596;53528;23763;318277
1979;67;Bas-Rhin;285651;145048;140603;271905;201264;97609;42459;898888
1979;68;Haut-Rhin;204298;104525;99773;192334;148169;66347;31105;642253
1979;69;Rhône;450851;229761;221090;440000;331947;144379;68407;1435584
1979;70;Haute-Saône;74558;38436;36122;60619;49560;28638;13977;227352
1979;71;Saône-et-Loire;174666;89661;85005;148544;134409;74673;38450;570742
1979;72;Sarthe;167767;86260;81507;133953;109767;58613;28505;498605
1979;73;Savoie;98044;50099;47945;91942;73292;35140;16425;314843
1979;74;Haute-Savoie;151382;77628;73754;150907;104411;46016;19430;472146
1979;75;Paris;439780;220564;219216;771450;540973;315182;162144;2229529
1979;76;Seine-Maritime;395686;201828;193858;347835;261107;122603;55339;1182570
1979;77;Seine-et-Marne;280870;143656;137214;254083;176240;74734;38698;824625
1979;78;Yvelines;387132;198638;188494;369091;264582;81221;40822;1142848
1979;79;Deux-Sèvres;109143;56148;52995;87498;77737;43577;21927;339882
1979;80;Somme;184265;93702;90563;150222;116108;60828;30349;541772
1979;81;Tarn;94978;49202;45776;84025;86088;48308;25398;338797
1979;82;Tarn-et-Garonne;53478;27452;26026;47015;45642;27842;13389;187366
1979;83;Var;181865;94089;87776;180001;163236;101633;43143;669878
1979;84;Vaucluse;123308;63355;59953;116089;96470;50832;23239;409938
1979;85;Vendée;155858;79880;75978;122144;104120;58714;27370;468206
1979;86;Vienne;113041;57394;55647;99168;81234;47382;24158;364983
1979;87;Haute-Vienne;92148;46964;45184;93420;86611;53537;28396;354112
1979;88;Vosges;130039;66618;63421;107719;88860;47911;22119;396648
1979;89;Yonne;90545;46593;43952;78589;66900;45015;24583;305632
1979;90;Territoire de Belfort;42172;21780;20392;38961;29679;13173;6277;130262
1979;91;Essonne;328413;168255;160158;310183;217575;65349;35420;956940
1979;92;Hauts-de-Seine;369964;187582;182382;459291;363058;144987;70450;1407750
1979;93;Seine-Saint-Denis;416416;213164;203252;424368;320094;107828;50462;1319168
1979;94;Val-de-Marne;353155;179488;173667;387987;294807;107723;56992;1200664
1979;95;Val-d'Oise;298925;152970;145955;283181;202347;64682;33230;882365
1980;01;Ain;127107;65217;61890;119195;91301;43861;22675;404139
1980;02;Aisne;177074;90962;86112;149106;121068;56158;29795;533201
1980;03;Allier;102295;52336;49959;93292;92533;54118;30014;372252
1980;04;Alpes-de-Haute-Provence;32507;16917;15590;31054;28492;16363;8354;116770
1980;05;Hautes-Alpes;29168;15150;14018;29543;24231;13235;6561;102738
1980;06;Alpes-Maritimes;200174;101988;98186;223880;212318;144697;79025;860094
1980;07;Ardèche;76695;39507;37188;69228;63361;35549;19493;264326
1980;08;Ardennes;104521;53538;50983;83526;69332;30996;15897;304272
1980;09;Ariège;33970;17444;16526;32332;34320;22448;13083;136153
1980;10;Aube;89153;45867;43286;82333;64089;33588;18704;287867
1980;11;Aude;71819;37457;34362;67271;69910;43976;24776;277752
1980;12;Aveyron;75287;38533;36754;68327;69320;42968;22563;278465
1980;13;Bouches-du-Rhône;497615;255062;242553;500449;407460;196895;93021;1695440
1980;14;Calvados;195976;100062;95914;172080;126718;57843;27549;580166
1980;15;Cantal;47733;24454;23279;41499;39728;23441;11742;164143
1980;16;Charente;99206;50652;48554;89756;81531;44937;24314;339744
1980;17;Charente-Maritime;150623;77260;73363;132449;120328;69318;35610;508328
1980;18;Cher;92154;47007;45147;85198;74095;43632;23463;318542
1980;19;Corrèze;61747;31810;29937;59930;60901;38387;20403;241368
1980;21;Côte-d'Or;149319;75603;73716;139454;102702;49846;26677;467998
1980;22;Côtes-d'Armor;163488;84153;79335;134355;129212;74309;33369;534733
1980;23;Creuse;33655;17269;16386;31040;36328;25268;15542;141833
1980;24;Dordogne;97958;50392;47566;90808;95998;60329;30810;375903
1980;25;Doubs;162761;82654;80107;146091;103160;43387;19494;474893
1980;26;Drôme;117280;60259;57021;106757;88427;44767;22941;380172
1980;27;Eure;151295;77316;73979;131805;97658;46035;22480;449273
1980;28;Eure-et-Loir;114680;59005;55675;101919;76970;40085;20215;353869
1980;29;Finistère;250884;128543;122341;214856;196665;109893;48141;820439
1980;2A;Corse-du-Sud;27594;13973;13621;30121;25965;15409;7097;106186
1980;2B;Haute-Corse;33388;17313;16075;37420;32053;18014;8672;129547
1980;30;Gard;146958;75510;71448;141160;126858;67893;35058;517927
1980;31;Haute-Garonne;231991;118302;113689;248053;190306;92618;46199;809167
1980;32;Gers;45372;23420;21952;42429;45464;26954;14496;174715
1980;33;Gironde;321801;163819;157982;323798;257986;130974;71955;1106514
1980;34;Hérault;193751;98657;95094;193059;160603;91713;47507;686633
1980;35;Ille-et-Vilaine;244076;124234;119842;212217;165420;78563;34502;734778
1980;36;Indre;67983;34783;33200;61055;58821;36512;20647;245018
1980;37;Indre-et-Loire;156367;79179;77188;141854;110024;57950;31005;497200
1980;38;Isère;292199;149781;142418;281449;206904;88195;43135;911882
1980;39;Jura;75449;38684;36765;64629;55875;30257;15492;241702
1980;40;Landes;82421;42416;40005;75206;73088;41670;22132;294517
1980;41;Loir-et-Cher;87523;44910;42613;77071;66531;39308;22064;292497
1980;42;Loire;229031;116815;112216;204742;177052;85719;43644;740188
1980;43;Haute-Loire;58878;30245;28633;52092;50167;28481;16222;205840
1980;44;Loire-Atlantique;328836;168372;160464;280721;220204;98211;47952;975924
1980;45;Loiret;162285;82703;79582;153863;115334;58681;30461;520624
1980;46;Lot;39853;20455;19398;37557;38399;24542;12886;153237
1980;47;Lot-et-Garonne;81983;41862;40121;75857;73922;42808;21807;296377
1980;48;Lozère;20707;10626;10081;19321;17263;11063;6109;74463
1980;49;Maine-et-Loire;232373;118346;114027;184558;139978;67347;36084;660340
1980;50;Manche;149144;76308;72836;119515;111178;56770;24807;461414
1980;51;Marne;179583;91648;87935;165301;115266;51790;26582;538522
1980;52;Haute-Marne;70061;36068;33993;57979;47259;23709;11968;210976
1980;53;Mayenne;89752;45980;43772;71418;61674;31190;14656;268690
1980;54;Meurthe-et-Moselle;232102;118344;113758;216150;166264;69996;33306;717818
1980;55;Meuse;65033;33703;31330;54436;46398;23227;12215;201309
1980;56;Morbihan;188965;97312;91653;153401;137896;72433;29930;582625
1980;57;Moselle;338154;173095;165059;301548;238496;90299;36567;1005064
1980;58;Nièvre;66570;34196;32374;60215;57115;36375;21264;241539
1980;59;Nord;870968;444471;426497;727122;561078;235383;116952;2511503
1980;60;Oise;221844;113872;107972;196876;136914;57432;30319;643385
1980;61;Orne;96247;49315;46932;78162;68960;34261;17042;294672
1980;62;Pas-de-Calais;485884;248108;237776;387179;321497;147834;64896;1407290
1980;63;Puy-de-Dôme;174321;89074;85247;173617;141445;66513;34125;590021
1980;64;Pyrénées-Atlantiques;157851;80443;77408;144218;133202;75038;38604;548913
1980;65;Hautes-Pyrénées;61682;31700;29982;59408;58039;32377;15728;227234
1980;66;Pyrénées-Orientales;86268;44437;41831;77363;81328;53601;24523;323083
1980;67;Bas-Rhin;283329;143963;139366;276866;204042;95432;44151;903820
1980;68;Haut-Rhin;202773;103772;99001;194978;150345;64580;32158;644834
1980;69;Rhône;447664;227955;219709;443393;335505;141264;70320;1438146
1980;70;Haute-Saône;74444;38384;36060;61869;50425;27740;14345;228823
1980;71;Saône-et-Loire;173093;88945;84148;150158;135849;72565;39485;571150
1980;72;Sarthe;165870;85303;80567;136562;111160;57522;29386;500500
1980;73;Savoie;97505;49938;47567;94088;74443;34567;16926;317529
1980;74;Haute-Savoie;152088;78109;73979;154054;106884;45606;20172;478804
1980;75;Paris;437432;219650;217782;771100;536946;300864;164814;2211156
1980;76;Seine-Maritime;391741;199941;191800;353275;263165;120456;57043;1185680
1980;77;Seine-et-Marne;285200;145869;139331;262536;182277;73677;39921;843611
1980;78;Yvelines;389343;199756;189587;375212;272257;80202;42289;1159303
1980;79;Deux-Sèvres;107799;55481;52318;89251;78798;42430;22528;340806
1980;80;Somme;182253;92746;89507;152651;117179;59328;30874;542285
1980;81;Tarn;93831;48603;45228;85233;86842;46862;26173;338941
1980;82;Tarn-et-Garonne;53057;27230;25827;48097;46221;27097;13827;188299
1980;83;Var;183176;94678;88498;185150;166581;101882;44906;681695
1980;84;Vaucluse;123863;63667;60196;118906;98058;50530;23934;415291
1980;85;Vendée;155516;79701;75815;125223;106094;57522;28370;472725
1980;86;Vienne;112141;56909;55232;101183;82393;46202;24957;366876
1980;87;Haute-Vienne;91368;46540;44828;94836;87097;52046;29110;354457
1980;88;Vosges;128392;65825;62567;108607;90139;46295;22908;396341
1980;89;Yonne;90182;46394;43788;79984;67948;43810;25206;307130
1980;90;Territoire de Belfort;41950;21685;20265;39429;30153;12777;6463;130772
1980;91;Essonne;327688;167980;159708;313698;224145;64758;36520;966809
1980;92;Hauts-de-Seine;364574;185022;179552;460216;362174;141233;72350;1400547
1980;93;Seine-Saint-Denis;412619;210927;201692;429135;320782;105341;51683;1319560
1980;94;Val-de-Marne;348616;177482;171134;389275;296288;105289;58062;1197530
1980;95;Val-d'Oise;299724;153454;146270;289460;206447;63717;34412;893760
1981;01;Ain;128770;66078;62692;122608;91120;44789;23311;410598
1981;02;Aisne;175976;90451;85525;151539;118795;57354;30308;533972
1981;03;Allier;101086;51743;49343;94606;90598;54388;30615;371293
1981;04;Alpes-de-Haute-Provence;32404;16857;15547;31784;28321;16707;8625;117841
1981;05;Hautes-Alpes;29213;15185;14028;30451;23946;13615;6714;103939
1981;06;Alpes-Maritimes;201267;102612;98655;228128;211611;147619;81470;870095
1981;07;Ardèche;76755;39494;37261;70717;62547;36080;19952;266051
1981;08;Ardennes;103188;52830;50358;84416;68286;31394;16191;303475
1981;09;Ariège;33660;17292;16368;33026;33388;22634;13283;135991
1981;10;Aube;88680;45649;43031;83525;63424;33899;19143;288671
1981;11;Aude;71722;37382;34340;69369;67930;44722;25448;279191
1981;12;Aveyron;74771;38284;36487;69667;67909;43126;23256;278729
1981;13;Bouches-du-Rhône;499296;256006;243290;508580;404431;202342;95545;1710194
1981;14;Calvados;195638;99858;95780;175961;125053;59736;28450;584838
1981;15;Cantal;47030;24044;22986;42114;38837;23565;12060;163606
1981;16;Charente;98394;50273;48121;91545;80037;45394;25099;340469
1981;17;Charente-Maritime;149720;76889;72831;135284;118114;71066;36668;510852
1981;18;Cher;91503;46690;44813;86634;73215;43976;23911;319239
1981;19;Corrèze;61309;31525;29784;61182;59417;38817;20942;241667
1981;21;Côte-d'Or;148589;75248;73341;142149;101981;50785;27341;470845
1981;22;Côtes-d'Armor;162659;83707;78952;136949;126579;75974;34547;536708
1981;23;Creuse;33122;17075;16047;31544;35409;25043;15909;141027
1981;24;Dordogne;97183;49946;47237;92625;93920;61288;31669;376685
1981;25;Doubs;161506;82066;79440;147209;103046;44304;20080;476145
1981;26;Drôme;118126;60739;57387;109156;87969;45826;23580;384657
1981;27;Eure;152356;78049;74307;135571;97451;47130;23126;455634
1981;28;Eure-et-Loir;115289;59274;56015;104230;76747;40946;20832;358044
1981;29;Finistère;249875;128045;121830;220303;192875;111837;49681;824571
1981;2A;Corse-du-Sud;28008;14148;13860;30417;25995;15751;7217;107388
1981;2B;Haute-Corse;33572;17333;16239;37664;32176;18124;8951;130487
1981;30;Gard;147501;75901;71600;145312;124931;69904;36012;523660
1981;31;Haute-Garonne;230865;117763;113102;254806;188231;94916;47517;816335
1981;32;Gers;44741;23136;21605;43168;44581;27212;14892;174594
1981;33;Gironde;322890;164499;158391;332877;253659;134354;73448;1117228
1981;34;Hérault;194488;99116;95372;199322;158375;94562;48707;695454
1981;35;Ille-et-Vilaine;244822;124535;120287;218058;163240;80771;35626;742517
1981;36;Indre;66858;34210;32648;61920;57619;36673;21090;244160
1981;37;Indre-et-Loire;156123;79037;77086;144959;109144;59327;31868;501421
1981;38;Isère;293846;150655;143191;288109;207044;90326;44303;923628
1981;39;Jura;75197;38585;36612;65567;55139;30749;15870;242522
1981;40;Landes;81821;42179;39642;76986;72088;42146;22879;295920
1981;41;Loir-et-Cher;87009;44528;42481;78847;65746;40002;22690;294294
1981;42;Loire;227665;116175;111490;206843;174459;86788;44617;740372
1981;43;Haute-Loire;58516;30076;28440;53058;49451;28557;16476;206058
1981;44;Loire-Atlantique;329121;168393;160728;287843;217741;101064;49261;985030
1981;45;Loiret;163459;83235;80224;157763;115126;60053;31320;527721
1981;46;Lot;39601;20326;19275;38433;37743;24858;13271;153906
1981;47;Lot-et-Garonne;81597;41698;39899;77111;72636;43665;22308;297317
1981;48;Lozère;20561;10565;9996;19679;16929;11037;6261;74467
1981;49;Maine-et-Loire;233484;119121;114363;189367;138678;68897;37024;667450
1981;50;Manche;148231;75800;72431;122588;108876;58158;25770;463623
1981;51;Marne;178632;91195;87437;168131;114249;52787;27173;540972
1981;52;Haute-Marne;69251;35674;33577;58757;46592;24015;12216;210831
1981;53;Mayenne;89615;45953;43662;72982;60561;31798;15201;270157
1981;54;Meurthe-et-Moselle;229157;116936;112221;218340;164799;70938;34204;717438
1981;55;Meuse;64214;33268;30946;55217;45643;23361;12420;200855
1981;56;Morbihan;188379;97061;91318;157447;135980;73854;31080;586740
1981;57;Moselle;333350;170878;162472;305997;236766;92398;37723;1006234
1981;58;Nièvre;65648;33779;31869;60937;56159;36400;21668;240812
1981;59;Nord;866491;442574;423917;738773;549158;241623;119498;2515543
1981;60;Oise;223095;114527;108568;201950;137079;58838;30990;651952
1981;61;Orne;95398;48826;46572;79540;67623;35051;17536;295148
1981;62;Pas-de-Calais;482587;246565;236022;393989;315421;150814;66574;1409385
1981;63;Puy-de-Dôme;173757;88824;84933;176703;139432;67781;34850;592523
1981;64;Pyrénées-Atlantiques;156431;79787;76644;147796;132057;75888;39924;552096
1981;65;Hautes-Pyrénées;61051;31360;29691;60506;57151;32693;16149;227550
1981;66;Pyrénées-Orientales;87325;44913;42412;80324;80396;55001;25473;328519
1981;67;Bas-Rhin;281634;143341;138293;283205;203017;96057;45818;909731
1981;68;Haut-Rhin;201873;103235;98638;197917;149916;64904;33088;647698
1981;69;Rhône;445194;226612;218582;448108;332680;143676;72529;1442187
1981;70;Haute-Saône;74697;38559;36138;63154;49977;28000;14657;230485
1981;71;Saône-et-Loire;171997;88332;83665;152210;133717;73523;40342;571789
1981;72;Sarthe;164689;84707;79982;139379;109544;58805;30247;502664
1981;73;Savoie;97485;50000;47485;96180;73913;35539;17413;320530
1981;74;Haute-Savoie;153414;78733;74681;156986;107726;46793;21081;486000
1981;75;Paris;435204;218867;216337;773266;524120;296262;166476;2195328
1981;76;Seine-Maritime;389419;198776;190643;359178;259376;123012;58800;1189785
1981;77;Seine-et-Marne;290440;148601;141839;272060;184800;75452;41147;863899
1981;78;Yvelines;392389;201282;191107;382279;275406;82977;43722;1176773
1981;79;Deux-Sèvres;107114;55256;51858;90978;77466;43186;23158;341902
1981;80;Somme;181005;92167;88838;155556;115409;60099;31417;543486
1981;81;Tarn;93001;48123;44878;87010;84888;47561;26859;339319
1981;82;Tarn-et-Garonne;52778;27085;25693;49429;45445;27526;14220;189398
1981;83;Var;185470;95958;89512;190296;166368;105798;46606;694538
1981;84;Vaucluse;124889;64183;60706;121752;97865;51918;24743;421167
1981;85;Vendée;155745;79953;75792;128574;105225;58821;29183;477548
1981;86;Vienne;111565;56742;54823;103896;81236;46862;25678;369237
1981;87;Haute-Vienne;90822;46256;44566;96837;85309;52390;29792;355150
1981;88;Vosges;127498;65354;62144;109945;88996;46443;23581;396463
1981;89;Yonne;90256;46481;43775;81615;67325;44090;25809;309095
1981;90;Territoire de Belfort;41913;21649;20264;39961;29984;12966;6632;131456
1981;91;Essonne;327433;167860;159573;318377;226614;67368;37493;977285
1981;92;Hauts-de-Seine;360362;182845;177517;461478;355383;143183;74280;1394686
1981;93;Seine-Saint-Denis;411102;210075;201027;434041;316462;107441;52769;1321815
1981;94;Val-de-Marne;344584;175649;168935;391743;292032;108018;58928;1195305
1981;95;Val-d'Oise;302302;154813;147489;295852;207285;65746;35392;906577
1982;01;Ain;130602;67009;63593;125959;91171;45702;23889;417323
1982;02;Aisne;174452;89684;84768;154876;116004;58348;30805;534485
1982;03;Allier;99735;51087;48648;96055;88337;54841;31121;370089
1982;04;Alpes-de-Haute-Provence;32250;16765;15485;32603;28241;16961;8880;118935
1982;05;Hautes-Alpes;29294;15253;14041;31308;23737;13901;6896;105136
1982;06;Alpes-Maritimes;202945;103817;99128;232625;211663;149967;83614;880814
1982;07;Ardèche;76799;39594;37205;72242;61866;36668;20394;267969
1982;08;Ardennes;101906;52226;49680;85927;66668;31800;16485;302786
1982;09;Ariège;33357;17197;16160;33711;32495;22679;13492;135734
1982;10;Aube;88165;45366;42799;85087;62527;34208;19492;289479
1982;11;Aude;71520;37296;34224;71365;66268;45482;25956;280591
1982;12;Aveyron;74146;37900;36246;70866;66634;43441;23779;278866
1982;13;Bouches-du-Rhône;499900;256362;243538;517936;402444;207046;97371;1724697
1982;14;Calvados;194370;99350;95020;180801;123611;61239;29241;589262
1982;15;Cantal;46331;23622;22709;42904;37845;23830;12259;163169
1982;16;Charente;97539;49818;47721;93256;78481;46061;25682;341019
1982;17;Charente-Maritime;148707;76415;72292;138308;115973;72722;37596;513306
1982;18;Cher;90730;46357;44373;88400;72156;44304;24388;319978
1982;19;Corrèze;60753;31233;29520;62369;57872;39428;21399;241821
1982;21;Côte-d'Or;147565;74828;72737;145452;100895;51757;27945;473614
1982;22;Côtes-d'Armor;161780;83216;78564;140394;123813;77405;35555;538947
1982;23;Creuse;32507;16748;15759;32259;34101;24966;16183;140016
1982;24;Dordogne;96399;49605;46794;94639;91737;62099;32648;377522
1982;25;Doubs;159836;81256;78580;149294;102341;45171;20613;477255
1982;26;Drôme;118769;61060;57709;111446;87928;46867;24178;389188
1982;27;Eure;153152;78539;74613;139834;97026;48034;23735;461781
1982;28;Eure-et-Loir;116055;59609;56446;106897;76421;41675;21503;362551
1982;29;Finistère;248776;127604;121172;227191;188655;113025;51104;828751
1982;2A;Corse-du-Sud;28368;14319;14049;30843;26090;15980;7322;108603
1982;2B;Haute-Corse;33674;17229;16445;38590;31948;18382;8978;131572
1982;30;Gard;147901;76130;71771;149432;123750;71696;36782;529561
1982;31;Haute-Garonne;229662;117152;112510;261687;186524;97159;48797;823829
1982;32;Gers;44084;22828;21256;43978;43686;27353;15354;174455
1982;33;Gironde;323185;164880;158305;342624;249818;137521;74786;1127934
1982;34;Hérault;195190;99649;95541;205945;156682;96944;49844;704605
1982;35;Ille-et-Vilaine;244528;124456;120072;224898;161120;82606;36615;749767
1982;36;Indre;65903;33689;32214;62789;56269;36912;21521;243394
1982;37;Indre-et-Loire;155572;78773;76799;148546;108460;60480;32670;505728
1982;38;Isère;295489;151463;144026;294565;207696;92656;45472;935878
1982;39;Jura;74665;38335;36330;66670;54322;31279;16219;243155
1982;40;Landes;81230;41951;39279;78702;71075;42859;23465;297331
1982;41;Loir-et-Cher;86704;44411;42293;80650;65013;40681;23199;296247
1982;42;Loire;225885;115185;110700;209250;171585;88064;45409;740193
1982;43;Haute-Loire;58206;29967;28239;54135;48461;28905;16658;206365
1982;44;Loire-Atlantique;328696;168061;160635;296324;214822;104163;50263;994268
1982;45;Loiret;164917;83920;80997;162041;114823;61309;32136;535226
1982;46;Lot;39260;20146;19114;39364;37012;25284;13627;154547
1982;47;Lot-et-Garonne;81191;41513;39678;78241;71643;44378;22853;298306
1982;48;Lozère;20402;10499;9903;20085;16529;11093;6331;74440
1982;49;Maine-et-Loire;234024;119563;114461;195021;137288;70183;37908;674424
1982;50;Manche;147443;75467;71976;126131;106355;59485;26483;465897
1982;51;Marne;177624;90733;86891;171566;112840;53579;27828;543437
1982;52;Haute-Marne;68491;35308;33183;59813;45673;24390;12419;210786
1982;53;Mayenne;89516;45957;43559;74832;59491;32193;15696;271728
1982;54;Meurthe-et-Moselle;225789;115251;110538;222798;161810;72027;35032;717456
1982;55;Meuse;63555;32967;30588;56222;44439;23620;12643;200479
1982;56;Morbihan;187888;96838;91050;162406;133135;75485;32073;590987
1982;57;Moselle;328448;168327;160121;311086;234747;94683;38779;1007743
1982;58;Nièvre;64665;33279;31386;61960;54755;36664;21978;240022
1982;59;Nord;861685;440604;421081;757844;533077;246858;121533;2520997
1982;60;Oise;224476;115228;109248;207700;137112;59980;31610;660878
1982;61;Orne;94544;48466;46078;81022;66196;35836;17966;295564
1982;62;Pas-de-Calais;479665;245133;234532;404861;306464;153417;68047;1412454
1982;63;Puy-de-Dôme;172560;88343;84217;180494;137182;69136;35491;594863
1982;64;Pyrénées-Atlantiques;155079;79246;75833;151562;130793;76889;41040;555363
1982;65;Hautes-Pyrénées;60289;30976;29313;61732;56395;32892;16549;227857
1982;66;Pyrénées-Orientales;88275;45413;42862;83507;79850;56196;26348;334176
1982;67;Bas-Rhin;279371;142348;137023;288914;203192;96791;47291;915559
1982;68;Haut-Rhin;200437;102570;97867;201017;149516;65617;33889;650476
1982;69;Rhône;442087;225244;216843;453502;330605;146196;74173;1446563
1982;70;Haute-Saône;74802;38610;36192;64767;49345;28228;14925;232067
1982;71;Saône-et-Loire;170818;87680;83138;154711;131410;74231;41255;572425
1982;72;Sarthe;163437;84100;79337;142547;108356;59621;31039;505000
1982;73;Savoie;97182;49893;47289;98445;73584;36348;17895;323454
1982;74;Haute-Savoie;154499;79396;75103;160223;108736;48112;21819;493389
1982;75;Paris;432775;217541;215234;776757;512580;290419;167790;2180321
1982;76;Seine-Maritime;386968;197480;189488;366881;255434;124802;60282;1194367
1982;77;Seine-et-Marne;295898;151600;144298;282607;187336;76915;42325;885081
1982;78;Yvelines;395164;202684;192480;390768;278127;85727;44818;1194604
1982;79;Deux-Sèvres;106341;54828;51513;92836;76365;43807;23628;342977
1982;80;Somme;179555;91430;88125;159295;113372;60642;31913;544777
1982;81;Tarn;92151;47686;44465;88439;83148;48210;27529;339477
1982;82;Tarn-et-Garonne;52454;26880;25574;50743;44706;28024;14624;190551
1982;83;Var;187648;97146;90502;195518;167088;108698;48570;707522
1982;84;Vaucluse;125635;64610;61025;124599;97937;53111;25602;426884
1982;85;Vendée;155864;80117;75747;132593;104036;60119;29908;482520
1982;86;Vienne;110620;56264;54356;106939;79983;47457;26413;371412
1982;87;Haute-Vienne;90131;45904;44227;98957;83434;52634;30532;355688
1982;88;Vosges;126573;64843;61730;112129;87011;46629;24191;396533
1982;89;Yonne;90309;46528;43781;83477;66499;44400;26317;311002
1982;90;Territoire de Belfort;41766;21547;20219;40755;29755;13047;6819;132142
1982;91;Essonne;325922;167150;158772;324470;228896;69742;38341;987371
1982;92;Hauts-de-Seine;356087;180857;175230;464381;348696;144293;75946;1389403
1982;93;Seine-Saint-Denis;410048;209499;200549;439693;312181;109291;53630;1324843
1982;94;Val-de-Marne;341059;173911;167148;394427;288108;109912;59883;1193389
1982;95;Val-d'Oise;304335;155964;148371;303686;207911;67477;36195;919604
1983;01;Ain;130525;67134;63391;129756;91780;45997;24685;422743
1983;02;Aisne;171904;88981;82923;158716;114370;58649;31333;534972
1983;03;Allier;96732;49756;46976;96716;87831;55493;32124;368896
1983;04;Alpes-de-Haute-Provence;31429;16264;15165;32985;29109;17298;9251;120072
1983;05;Hautes-Alpes;28834;15208;13626;31204;23940;14577;7067;105622
1983;06;Alpes-Maritimes;205936;104900;101036;238651;213734;148222;86568;893111
1983;07;Ardèche;75158;38961;36197;72819;62805;38156;21184;270122
1983;08;Ardennes;98832;50892;47940;88022;66235;32003;16934;302026
1983;09;Ariège;32467;16790;15677;34726;32228;22986;14049;136456
1983;10;Aube;86985;44941;42044;85906;62346;34159;19732;289128
1983;11;Aude;70008;36755;33253;72525;67455;46408;26787;283183
1983;12;Aveyron;71928;36867;35061;70495;66786;44486;24853;278548
1983;13;Bouches-du-Rhône;495539;253058;242481;517349;404457;211441;100550;1729336
1983;14;Calvados;196577;99786;96791;184164;122344;62243;29981;595309
1983;15;Cantal;44557;22977;21580;43304;37580;23969;12779;162189
1983;16;Charente;95213;48725;46488;95103;77979;46453;26270;341018
1983;17;Charente-Maritime;144805;74833;69972;140210;116888;74019;39265;515187
1983;18;Cher;89356;45531;43825;90575;72203;44478;25130;321742
1983;19;Corrèze;58875;30622;28253;62697;57699;39773;22009;241053
1983;21;Côte-d'Or;149753;75478;74275;146691;99297;51844;28386;475971
1983;22;Côtes-d'Armor;156745;81199;75546;142273;124378;78929;37074;539399
1983;23;Creuse;31023;16112;14911;32617;33790;25073;16817;139320
1983;24;Dordogne;94166;48858;45308;96814;91927;62767;33719;379393
1983;25;Doubs;160804;81827;78977;152039;100435;45498;21115;479891
1983;26;Drôme;117040;60428;56612;113225;89843;48288;25327;393723
1983;27;Eure;152508;78412;74096;144337;97700;48473;24567;467585
1983;28;Eure-et-Loir;116119;59895;56224;110826;76414;41208;22192;366759
1983;29;Finistère;245174;126157;119017;229335;187417;115180;53109;830215
1983;2A;Corse-du-Sud;27010;13988;13022;32314;26694;16109;7633;109760
1983;2B;Haute-Corse;32164;16677;15487;40089;31537;18650;9229;131669
1983;30;Gard;148078;76347;71731;152008;126012;73746;37925;537769
1983;31;Haute-Garonne;242100;121864;120236;266355;184178;95666;48878;837177
1983;32;Gers;41988;21877;20111;44593;43386;27467;16010;173444
1983;33;Gironde;331336;168435;162901;346117;246509;138927;75039;1137928
1983;34;Hérault;201443;102130;99313;208380;158439;98577;51781;718620
1983;35;Ille-et-Vilaine;248493;125720;122773;227164;158876;83523;37433;755489
1983;36;Indre;64077;33009;31068;64140;55999;36977;22194;243387
1983;37;Indre-et-Loire;157289;78857;78432;150249;108230;60482;33884;510134
1983;38;Isère;299792;153853;145939;296401;207825;94882;46871;945771
1983;39;Jura;73133;37660;35473;68362;53932;31225;16901;243553
1983;40;Landes;79348;41167;38181;80870;71488;43482;23872;299060
1983;41;Loir-et-Cher;85526;43935;41591;82627;65079;40553;23963;297748
1983;42;Loire;225938;115544;110394;211673;169297;89842;46496;743246
1983;43;Haute-Loire;56877;29450;27427;55021;47939;29162;17133;206132
1983;44;Loire-Atlantique;330472;169075;161397;301478;214632;106975;51340;1004897
1983;45;Loiret;165892;84428;81464;165755;114764;61516;33326;541253
1983;46;Lot;38092;19717;18375;39729;37542;25864;14066;155293
1983;47;Lot-et-Garonne;79604;40924;38680;79402;71918;45411;23961;300296
1983;48;Lozère;19810;10189;9621;20316;16618;11329;6575;74648
1983;49;Maine-et-Loire;235363;120110;115253;196500;137915;72114;39347;681239
1983;50;Manche;143596;73769;69827;129486;106553;60804;27733;468172
1983;51;Marne;178547;90834;87713;174052;111313;53869;28402;546183
1983;52;Haute-Marne;66770;34606;32164;60406;45710;25029;13099;211014
1983;53;Mayenne;87636;45045;42591;76412;59153;32949;16330;272480
1983;54;Meurthe-et-Moselle;227824;115940;111884;225563;157128;72942;35573;719030
1983;55;Meuse;61573;32230;29343;57373;43676;23825;13034;199481
1983;56;Morbihan;184237;95278;88959;165762;134169;77057;33180;594405
1983;57;Moselle;321244;165218;156026;316345;233006;96458;39655;1006708
1983;58;Nièvre;62315;32233;30082;63154;54481;36441;22658;239049
1983;59;Nord;865041;442614;422427;772263;522928;250302;122353;2532887
1983;60;Oise;226268;116158;110110;214160;137581;60384;32119;670512
1983;61;Orne;92208;47658;44550;82930;66610;36548;18719;297015
1983;62;Pas-de-Calais;474890;243131;231759;414909;303636;156815;69912;1420162
1983;63;Puy-de-Dôme;173296;88053;85243;180722;135123;70452;36293;595886
1983;64;Pyrénées-Atlantiques;154780;79059;75721;154235;131214;77235;42046;559510
1983;65;Hautes-Pyrénées;58896;30712;28184;61606;56355;34036;17493;228386
1983;66;Pyrénées-Orientales;85525;44002;41523;84540;81583;57994;28184;337826
1983;67;Bas-Rhin;283533;143413;140120;291168;201763;95983;47939;920386
1983;68;Haut-Rhin;197652;101617;96035;205627;148751;65897;34848;652775
1983;69;Rhône;447920;227204;220716;457675;323437;147358;74139;1450529
1983;70;Haute-Saône;71918;37208;34710;65024;50128;29113;15913;232096
1983;71;Saône-et-Loire;164900;85247;79653;156544;130888;75827;42315;570474
1983;72;Sarthe;160023;82462;77561;145102;108041;60375;32179;505720
1983;73;Savoie;97966;49877;48089;100223;73894;36687;18262;327032
1983;74;Haute-Savoie;155810;80301;75509;167990;109153;48996;22155;504104
1983;75;Paris;454614;227325;227289;765357;496877;293021;168408;2178277
1983;76;Seine-Maritime;384990;196433;188557;371927;251909;126552;61998;1197376
1983;77;Seine-et-Marne;302775;155212;147563;295175;188099;75670;42652;904371
1983;78;Yvelines;396456;203994;192462;396258;278794;89097;45858;1206463
1983;79;Deux-Sèvres;103513;53377;50136;94562;76183;44519;24626;343403
1983;80;Somme;178785;90824;87961;161790;112050;60933;32579;546137
1983;81;Tarn;90373;46854;43519;89570;82785;49494;28313;340535
1983;82;Tarn-et-Garonne;51619;26756;24863;51725;44499;28290;15261;191394
1983;83;Var;187471;97021;90450;199697;171758;109650;50617;719193
1983;84;Vaucluse;123850;63695;60155;125192;99767;54257;26774;429840
1983;85;Vendée;153213;79284;73929;135695;105353;61558;31171;486990
1983;86;Vienne;112325;56781;55544;106554;79273;47554;26976;372682
1983;87;Haute-Vienne;90895;46115;44780;98374;82826;53012;31899;357006
1983;88;Vosges;122389;62933;59456;113749;86451;47190;25134;394913
1983;89;Yonne;89424;46422;43002;86317;66268;43517;27149;312675
1983;90;Territoire de Belfort;41436;21827;19609;41495;29326;13473;6803;132533
1983;91;Essonne;327309;167989;159320;335050;225199;69533;38280;995371
1983;92;Hauts-de-Seine;359206;182064;177142;470241;333861;147828;74705;1385841
1983;93;Seine-Saint-Denis;407154;207745;199409;457013;304178;110749;52623;1331717
1983;94;Val-de-Marne;340962;173252;167710;406430;279509;111896;59377;1198174
1983;95;Val-d'Oise;306796;156927;149869;314880;205174;69294;35645;931789
1984;01;Ain;132108;67925;64183;132760;93084;46666;25362;429980
1984;02;Aisne;170391;88050;82341;161206;112939;59537;31792;535865
1984;03;Allier;95260;48970;46290;97590;86586;55690;32609;367735
1984;04;Alpes-de-Haute-Provence;31367;16208;15159;33655;29310;17582;9536;121450
1984;05;Hautes-Alpes;29044;15326;13718;31875;24170;14787;7312;107188
1984;06;Alpes-Maritimes;206087;104926;101161;242789;214630;148661;88945;901112
1984;07;Ardèche;74797;38786;36011;74289;62561;38533;21599;271779
1984;08;Ardennes;97250;50048;47202;89421;65259;32297;17227;301454
1984;09;Ariège;32265;16680;15585;35241;31892;23052;14356;136806
1984;10;Aube;86653;44771;41882;87456;62396;34530;20195;291230
1984;11;Aude;69821;36571;33250;74128;67074;46691;27283;284997
1984;12;Aveyron;70983;36411;34572;71354;65851;44717;25504;278409
1984;13;Bouches-du-Rhône;491440;251125;240315;521601;404199;212985;102580;1732805
1984;14;Calvados;195679;99297;96382;187546;121893;63765;30881;599764
1984;15;Cantal;43774;22543;21231;43778;36954;24012;13037;161555
1984;16;Charente;93993;48081;45912;96207;77200;46577;26796;340773
1984;17;Charente-Maritime;143152;73957;69195;141673;116147;75145;40269;516386
1984;18;Cher;88508;45191;43317;91500;71649;44539;25621;321817
1984;19;Corrèze;58254;30284;27970;63286;56722;39905;22483;240650
1984;21;Côte-d'Or;148431;74809;73622;148873;99541;52446;29044;478335
1984;22;Côtes-d'Armor;154676;80040;74636;143695;122574;79998;37980;538923
1984;23;Creuse;30210;15692;14518;32722;32759;24786;16926;137403
1984;24;Dordogne;93546;48472;45074;98773;90977;63582;34650;381528
1984;25;Doubs;159656;81283;78373;154141;101031;46516;21858;483202
1984;26;Drôme;117111;60411;56700;115249;90283;49079;25951;397673
1984;27;Eure;153483;78863;74620;147946;98440;49206;25227;474302
1984;28;Eure-et-Loir;116800;60262;56538;113211;76629;41776;22817;371233
1984;29;Finistère;242292;124616;117676;233221;184707;116269;54345;830834
1984;2A;Corse-du-Sud;27470;14206;13264;32688;26750;16434;7802;111144
1984;2B;Haute-Corse;32130;16489;15641;40426;31529;18747;9350;132182
1984;30;Gard;148547;76603;71944;155647;126667;75090;38811;544762
1984;31;Haute-Garonne;241421;121690;119731;273431;186029;97175;50402;848458
1984;32;Gers;41737;21781;19956;45522;43097;27946;16577;174879
1984;33;Gironde;329596;167598;161998;352765;246620;140910;76407;1146298
1984;34;Hérault;202331;102668;99663;214183;160096;100732;53189;730531
1984;35;Ille-et-Vilaine;247220;125148;122072;231550;158408;85114;38602;760894
1984;36;Indre;62955;32382;30573;64823;55442;36989;22611;242820
1984;37;Indre-et-Loire;155952;78215;77737;152564;108559;61338;34654;513067
1984;38;Isère;299581;153712;145869;301382;209881;96706;48043;955593
1984;39;Jura;72398;37311;35087;69211;53631;31546;17247;244033
1984;40;Landes;78911;40932;37979;82479;71186;44104;24554;301234
1984;41;Loir-et-Cher;84896;43642;41254;84034;64683;40986;24562;299161
1984;42;Loire;224215;114842;109373;213832;167942;90802;47651;744442
1984;43;Haute-Loire;56569;29262;27307;56056;47370;29259;17452;206706
1984;44;Loire-Atlantique;328862;168053;160809;306966;214235;109579;52429;1012071
1984;45;Loiret;165962;84523;81439;168733;115169;62319;34191;546374
1984;46;Lot;37850;19610;18240;40432;37342;26174;14494;156292
1984;47;Lot-et-Garonne;79257;40715;38542;80562;71472;46015;24648;301954
1984;48;Lozère;19677;10107;9570;20581;16484;11388;6705;74835
1984;49;Maine-et-Loire;234324;119572;114752;200038;137332;73728;40158;685580
1984;50;Manche;142515;73166;69349;132430;104887;61864;28496;470192
1984;51;Marne;177196;90198;86998;176622;111095;54443;29029;548385
1984;52;Haute-Marne;65697;33988;31709;61194;45167;25211;13440;210709
1984;53;Mayenne;87154;44890;42264;77773;58403;33468;16857;273655
1984;54;Meurthe-et-Moselle;224889;114535;110354;229037;155802;74285;36502;720515
1984;55;Meuse;60939;31832;29107;58323;42955;24070;13252;199539
1984;56;Morbihan;183082;94727;88355;169154;132677;78337;34314;597564
1984;57;Moselle;315955;162571;153384;321244;230947;98499;40789;1007434
1984;58;Nièvre;61441;31794;29647;63750;53789;36359;22951;238290
1984;59;Nord;852873;436294;416579;779386;512787;251761;123596;2520403
1984;60;Oise;226977;116629;110348;218916;138924;61178;32725;678720
1984;61;Orne;91129;47063;44066;83961;65766;37165;19136;297157
1984;62;Pas-de-Calais;471468;241335;230133;421998;297974;158980;71138;1421558
1984;63;Puy-de-Dôme;171499;87263;84236;182438;134576;71319;37027;596859
1984;64;Pyrénées-Atlantiques;152666;77995;74671;156698;130161;77690;43143;560358
1984;65;Hautes-Pyrénées;58007;30219;27788;62567;55997;34196;18003;228770
1984;66;Pyrénées-Orientales;85417;43964;41453;86868;81213;58664;29007;341169
1984;67;Bas-Rhin;280029;141751;138278;296739;202497;96094;49209;924568
1984;68;Haut-Rhin;195756;100603;95153;208499;148520;66382;35514;654671
1984;69;Rhône;443956;225094;218862;461627;324585;148246;76110;1454524
1984;70;Haute-Saône;71294;36937;34357;65847;49658;29104;16190;232093
1984;71;Saône-et-Loire;162383;83818;78565;157957;129174;76172;43008;568694
1984;72;Sarthe;158453;81559;76894;147556;107673;61393;32985;508060
1984;73;Savoie;96939;49420;47519;101483;73632;37177;18607;327838
1984;74;Haute-Savoie;157627;81244;76383;172385;111528;50252;23198;514990
1984;75;Paris;449933;225215;224718;771383;491656;286757;169270;2168999
1984;76;Seine-Maritime;382380;195231;187149;377351;250832;128145;63486;1202194
1984;77;Seine-et-Marne;306678;157269;149409;302513;192091;76320;43489;921091
1984;78;Yvelines;396305;203707;192598;400402;282989;91016;46711;1217423
1984;79;Deux-Sèvres;102145;52605;49540;95805;75305;44944;25130;343329
1984;80;Somme;177030;90055;86975;164596;111290;61835;32987;547738
1984;81;Tarn;89356;46282;43074;91027;81695;49978;29062;341118
1984;82;Tarn-et-Garonne;51307;26572;24735;52954;44348;28649;15691;192949
1984;83;Var;188799;97599;91200;204388;173295;112094;52621;731197
1984;84;Vaucluse;124119;63903;60216;127344;100479;55256;27553;434751
1984;85;Vendée;152826;79065;73761;138851;104564;63093;32186;491520
1984;86;Vienne;110954;56170;54784;108198;78727;47959;27651;373489
1984;87;Haute-Vienne;90244;45853;44391;99895;82313;53294;32558;358304
1984;88;Vosges;120739;62134;58605;114866;85431;47101;25659;393796
1984;89;Yonne;89145;46236;42909;87633;65767;43731;27538;313814
1984;90;Territoire de Belfort;41156;21636;19520;41995;29183;13697;6921;132952
1984;91;Essonne;325720;167158;158562;339043;229031;71089;39166;1004049
1984;92;Hauts-de-Seine;355626;180381;175245;473920;330591;148627;75911;1384675
1984;93;Seine-Saint-Denis;404837;206780;198057;462351;301471;111489;53212;1333360
1984;94;Val-de-Marne;337027;171236;165791;410050;278422;113491;60090;1199080
1984;95;Val-d'Oise;308657;157869;150788;321067;207092;70761;36236;943813
1985;01;Ain;132820;68261;64559;135393;94181;47236;26000;435630
1985;02;Aisne;168429;86912;81517;162662;111115;60551;32050;534807
1985;03;Allier;93785;48118;45667;98823;85593;55898;33349;367448
1985;04;Alpes-de-Haute-Provence;31372;16191;15181;34503;29538;17953;9833;123199
1985;05;Hautes-Alpes;29011;15267;13744;32332;24056;15057;7481;107937
1985;06;Alpes-Maritimes;205766;105006;100760;246722;216179;149091;90911;908669
1985;07;Ardèche;74331;38474;35857;75566;62130;38917;22062;273006
1985;08;Ardennes;96004;49380;46624;90479;64354;32661;17601;301099
1985;09;Ariège;31994;16553;15441;35807;31461;23089;14590;136941
1985;10;Aube;85607;44166;41441;88129;61963;34625;20528;290852
1985;11;Aude;69374;36287;33087;75684;66332;47094;27738;286222
1985;12;Aveyron;69948;35902;34046;72207;64696;44902;26224;277977
1985;13;Bouches-du-Rhône;486667;248759;237908;525673;404117;214699;104607;1735763
1985;14;Calvados;194298;98633;95665;190584;121358;65252;31730;603222
1985;15;Cantal;42951;22093;20858;44217;36391;24102;13319;160980
1985;16;Charente;92922;47592;45330;97227;76479;46849;27361;340838
1985;17;Charente-Maritime;141291;72976;68315;143446;115420;76259;41465;517881
1985;18;Cher;87399;44680;42719;92337;71182;44369;26178;321465
1985;19;Corrèze;57570;29859;27711;64251;55924;40093;23090;240928
1985;21;Côte-d'Or;147073;74042;73031;151238;99824;53109;29788;481032
1985;22;Côtes-d'Armor;152648;78773;73875;145164;120784;80912;39165;538673
1985;23;Creuse;29654;15392;14262;33139;31966;24676;17171;136606
1985;24;Dordogne;92504;47813;44691;100419;89740;64273;35497;382433
1985;25;Doubs;157567;80322;77245;155183;101548;47337;22576;484211
1985;26;Drôme;116982;60337;56645;117024;90401;49876;26565;400848
1985;27;Eure;154335;79395;74940;151250;99151;50079;25846;480661
1985;28;Eure-et-Loir;117647;60627;57020;115362;76990;42259;23534;375792
1985;29;Finistère;239601;123259;116342;237140;182218;117011;56067;832037
1985;2A;Corse-du-Sud;27673;14246;13427;33162;26875;16674;7859;112243
1985;2B;Haute-Corse;32014;16399;15615;40340;31523;18832;9503;132212
1985;30;Gard;149131;76778;72353;159101;127133;76451;39723;551539
1985;31;Haute-Garonne;240695;121491;119204;282294;188293;99190;52372;862844
1985;32;Gers;40997;21341;19656;45999;42240;28138;17024;174398
1985;33;Gironde;328864;167433;161431;360891;248177;143155;78428;1159515
1985;34;Hérault;203654;103350;100304;221406;162583;103406;54826;745875
1985;35;Ille-et-Vilaine;245527;124436;121091;236598;157683;86809;40055;766672
1985;36;Indre;61752;31756;29996;65409;54690;36985;23097;241933
1985;37;Indre-et-Loire;154540;77631;76909;155011;108761;62075;35586;515973
1985;38;Isère;298917;153455;145462;306036;211859;98574;49229;964615
1985;39;Jura;71872;36994;34878;69965;53600;31860;17717;245014
1985;40;Landes;78448;40721;37727;84154;70886;44770;25275;303533
1985;41;Loir-et-Cher;84219;43284;40935;85137;64526;41214;25211;300307
1985;42;Loire;221767;113636;108131;214559;166574;91469;48751;743120
1985;43;Haute-Loire;55996;28938;27058;57039;46710;29456;17691;206892
1985;44;Loire-Atlantique;326671;166993;159678;311953;213520;111420;53913;1017477
1985;45;Loiret;166468;84771;81697;171559;115761;63282;35185;552255
1985;46;Lot;37353;19328;18025;40819;36667;26407;14785;156031
1985;47;Lot-et-Garonne;78194;40146;38048;81363;70459;46322;25182;301520
1985;48;Lozère;19253;9878;9375;20662;16122;11265;6815;74117
1985;49;Maine-et-Loire;232605;118844;113761;203904;136698;74862;41274;689343
1985;50;Manche;141458;72586;68872;135135;103024;62831;29351;471799
1985;51;Marne;176157;89652;86505;179067;111409;55219;29813;551665
1985;52;Haute-Marne;64652;33477;31175;61785;44617;25429;13700;210183
1985;53;Mayenne;86775;44637;42138;79169;57755;33981;17504;275184
1985;54;Meurthe-et-Moselle;221925;112992;108933;232070;155093;75820;37488;722396
1985;55;Meuse;60377;31458;28919;58992;42392;24435;13495;199691
1985;56;Morbihan;181976;94071;87905;172571;131260;79662;35634;601103
1985;57;Moselle;312044;160715;151329;326655;228784;100840;42244;1010567
1985;58;Nièvre;60455;31271;29184;64386;52943;36423;23266;237473
1985;59;Nord;843992;431739;412253;786342;505651;254550;125243;2515778
1985;60;Oise;227257;116637;110620;223030;140182;62041;33266;685776
1985;61;Orne;90063;46456;43607;84953;64820;37957;19677;297470
1985;62;Pas-de-Calais;468443;239779;228664;428031;292986;161106;72565;1423131
1985;63;Puy-de-Dôme;169232;86140;83092;183835;133988;72251;37703;597009
1985;64;Pyrénées-Atlantiques;150688;76914;73774;159549;129372;78489;44335;562433
1985;65;Hautes-Pyrénées;56898;29651;27247;63424;55261;34306;18537;228426
1985;66;Pyrénées-Orientales;85253;43746;41507;89312;80864;59409;29947;344785
1985;67;Bas-Rhin;276197;139928;136269;303684;202294;96201;50563;928939
1985;68;Haut-Rhin;193913;99592;94321;211866;147972;66903;36245;656899
1985;69;Rhône;438505;222426;216079;465788;326393;149567;77818;1458071
1985;70;Haute-Saône;70600;36565;34035;66559;49445;29092;16469;232165
1985;71;Saône-et-Loire;159834;82434;77400;159076;127914;76504;43830;567158
1985;72;Sarthe;156668;80606;76062;149898;107145;62093;33960;509764
1985;73;Savoie;95818;48879;46939;102593;73574;37597;19033;328615
1985;74;Haute-Savoie;157867;81366;76501;175037;113529;51271;23967;521671
1985;75;Paris;445570;223255;222315;779256;489229;280661;171262;2165978
1985;76;Seine-Maritime;379705;193912;185793;381358;250130;129135;65251;1205579
1985;77;Seine-et-Marne;312359;160214;152145;311755;197403;77534;44620;943671
1985;78;Yvelines;397078;204167;192911;405204;287583;93379;47849;1231093
1985;79;Deux-Sèvres;100701;51873;48828;97168;74518;45296;25746;343429
1985;80;Somme;174660;88762;85898;166468;110455;62332;33530;547445
1985;81;Tarn;88537;45855;42682;92353;80735;50324;29857;341806
1985;82;Tarn-et-Garonne;50964;26372;24592;54012;44067;28897;16183;194123
1985;83;Var;190637;98661;91976;209068;175419;114845;54614;744583
1985;84;Vaucluse;124394;63955;60439;130088;101585;56309;28394;440770
1985;85;Vendée;151771;78446;73325;141891;103584;64319;33126;494691
1985;86;Vienne;109411;55452;53959;110092;78379;48389;28337;374608
1985;87;Haute-Vienne;88952;45214;43738;101150;81417;53240;33259;358018
1985;88;Vosges;118630;61030;57600;115580;84271;46936;26241;391658
1985;89;Yonne;89070;46187;42883;89011;65423;44042;27981;315527
1985;90;Territoire de Belfort;40830;21395;19435;42514;29220;13798;7108;133470
1985;91;Essonne;324385;166441;157944;343883;233348;72954;40191;1014761
1985;92;Hauts-de-Seine;352488;178359;174129;478493;328516;149516;77232;1386245
1985;93;Seine-Saint-Denis;404322;206561;197761;468868;300564;112623;53898;1340275
1985;94;Val-de-Marne;332720;169046;163674;413101;277532;114486;60968;1198807
1985;95;Val-d'Oise;311429;159412;152017;327523;209797;72272;37009;958030
1986;01;Ain;134140;68908;65232;138031;95628;48052;26593;442444
1986;02;Aisne;167219;86186;81033;164836;110067;61783;32436;536341
1986;03;Allier;92192;47214;44978;99264;84473;56097;33756;365782
1986;04;Alpes-de-Haute-Provence;31528;16226;15302;35414;29876;18361;10089;125268
1986;05;Hautes-Alpes;29165;15304;13861;32960;24191;15254;7762;109332
1986;06;Alpes-Maritimes;206645;105616;101029;253139;218082;151052;93403;922321
1986;07;Ardèche;73949;38279;35670;76519;62060;39344;22434;274306
1986;08;Ardennes;94927;48756;46171;91376;63586;33197;17871;300957
1986;09;Ariège;31654;16380;15274;36260;30943;23019;14800;136676
1986;10;Aube;84822;43731;41091;88871;61742;34836;20775;291046
1986;11;Aude;69045;36012;33033;77257;65661;47529;28105;287597
1986;12;Aveyron;68677;35262;33415;72530;63533;44756;26716;276212
1986;13;Bouches-du-Rhône;481751;246451;235300;529431;402833;216335;106894;1737244
1986;14;Calvados;192587;97855;94732;192769;121154;66672;32490;605672
1986;15;Cantal;42240;21687;20553;44634;35951;24230;13584;160639
1986;16;Charente;91737;47021;44716;98498;75596;47185;27971;340987
1986;17;Charente-Maritime;139850;72078;67772;145044;114575;77492;42583;519544
1986;18;Cher;86466;44264;42202;92906;70887;44337;26629;321225
1986;19;Corrèze;56982;29518;27464;64746;54978;40294;23558;240558
1986;21;Côte-d'Or;146018;73520;72498;153179;100240;53960;30453;483850
1986;22;Côtes-d'Armor;151032;77684;73348;146406;119064;81990;40155;538647
1986;23;Creuse;29090;15068;14022;33413;31124;24593;17283;135503
1986;24;Dordogne;91891;47499;44392;101779;88546;65102;36350;383668
1986;25;Doubs;154349;78680;75669;155046;101661;47875;23132;482063
1986;26;Drôme;116793;60271;56522;118532;90679;50662;27173;403839
1986;27;Eure;155382;79893;75489;154398;99914;51045;26432;487171
1986;28;Eure-et-Loir;118164;60861;57303;117018;77494;42836;24087;379599
1986;29;Finistère;237342;121991;115351;240759;179925;117636;57568;833230
1986;2A;Corse-du-Sud;27898;14380;13518;33683;26889;16865;8018;113353
1986;2B;Haute-Corse;31777;16282;15495;40436;31337;18919;9549;132018
1986;30;Gard;148950;76634;72316;161648;126917;77539;40205;555259
1986;31;Haute-Garonne;239182;120752;118430;289216;189629;100450;53800;872277
1986;32;Gers;40518;21137;19381;46691;41728;28484;17393;174814
1986;33;Gironde;328136;166939;161197;368270;248824;145500;80003;1170733
1986;34;Hérault;202836;102913;99923;225909;163026;105215;55741;752727
1986;35;Ille-et-Vilaine;243747;123621;120126;241584;157485;88233;41371;772420
1986;36;Indre;60775;31234;29541;65686;54064;37091;23373;240989
1986;37;Indre-et-Loire;153276;77066;76210;157660;109064;63060;36425;519485
1986;38;Isère;298161;153063;145098;310376;213216;100426;50245;972424
1986;39;Jura;71484;36788;34696;70679;53723;32344;18132;246362
1986;40;Landes;77986;40451;37535;85753;70634;45606;25760;305739
1986;41;Loir-et-Cher;83440;42915;40525;86197;64408;41546;25807;301398
1986;42;Loire;219364;112494;106870;215308;165426;92576;49694;742368
1986;43;Haute-Loire;55523;28671;26852;57723;46249;29624;17834;206953
1986;44;Loire-Atlantique;325539;166333;159206;316556;213114;113315;55400;1023924
1986;45;Loiret;166452;84747;81705;174003;116376;64260;36052;557143
1986;46;Lot;36734;18951;17783;41137;35850;26544;15156;155421
1986;47;Lot-et-Garonne;77578;39785;37793;82343;69782;46884;25674;302261
1986;48;Lozère;18933;9721;9212;20692;15847;11331;6875;73678
1986;49;Maine-et-Loire;231250;117992;113258;207669;136178;76331;42084;693512
1986;50;Manche;140501;72207;68294;137611;101602;63715;30192;473621
1986;51;Marne;173731;88517;85214;180135;111088;55650;30355;550959
1986;52;Haute-Marne;63242;32671;30571;61754;43804;25427;13921;208148
1986;53;Mayenne;86062;44300;41762;80153;56847;34342;18044;275448
1986;54;Meurthe-et-Moselle;217779;111001;106778;232922;153238;76796;38245;718980
1986;55;Meuse;60025;31240;28785;59896;41677;24910;13720;200228
1986;56;Morbihan;180979;93559;87420;175836;129892;81044;36845;604596
1986;57;Moselle;309413;159291;150122;332141;226470;103880;43424;1015328
1986;58;Nièvre;59620;30841;28779;64804;52094;36644;23456;236618
1986;59;Nord;837163;428082;409081;793286;501023;257281;127074;2515827
1986;60;Oise;227752;116895;110857;226631;141511;63248;33652;692794
1986;61;Orne;88800;45712;43088;85509;63708;38496;20056;296569
1986;62;Pas-de-Calais;466691;238851;227840;432547;288800;163514;73759;1425311
1986;63;Puy-de-Dôme;166706;84826;81880;184964;133469;73129;38439;596707
1986;64;Pyrénées-Atlantiques;149298;76380;72918;162458;128831;79507;45474;565568
1986;65;Hautes-Pyrénées;56081;29147;26934;64322;54601;34733;18927;228664
1986;66;Pyrénées-Orientales;84833;43568;41265;90795;80031;59728;30682;346069
1986;67;Bas-Rhin;273174;138329;134845;310940;200954;97148;51590;933806
1986;68;Haut-Rhin;192395;98828;93567;215094;146963;67885;36779;659116
1986;69;Rhône;433873;220261;213612;470585;327416;151533;79628;1463035
1986;70;Haute-Saône;70002;36310;33692;67003;49208;29179;16749;232141
1986;71;Saône-et-Loire;157381;81104;76277;159700;126404;77255;44373;565113
1986;72;Sarthe;154989;79623;75366;151780;106364;62999;34850;510982
1986;73;Savoie;95111;48566;46545;103881;73914;38160;19562;330628
1986;74;Haute-Savoie;157669;81182;76487;177553;115101;52317;24649;527289
1986;75;Paris;442078;221813;220265;787275;487896;275632;172513;2165394
1986;76;Seine-Maritime;377916;193048;184868;385106;249382;130889;66592;1209885
1986;77;Seine-et-Marne;318958;163742;155216;321284;202939;79427;45591;968199
1986;78;Yvelines;398022;204435;193587;410659;291504;96271;48921;1245377
1986;79;Deux-Sèvres;99651;51309;48342;98490;73836;45647;26373;343997
1986;80;Somme;172890;88005;84885;168331;109990;63038;33907;548156
1986;81;Tarn;87416;45259;42157;93192;79378;50821;30388;341195
1986;82;Tarn-et-Garonne;50515;26095;24420;54950;43741;29103;16587;194896
1986;83;Var;192571;99534;93037;214002;177173;117758;56705;758209
1986;84;Vaucluse;125023;64317;60706;132213;102601;57319;29137;446293
1986;85;Vendée;150913;77923;72990;144526;102819;65523;34029;497810
1986;86;Vienne;107919;54866;53053;112018;78020;48768;29036;375761
1986;87;Haute-Vienne;87762;44654;43108;101888;80402;53425;33700;357177
1986;88;Vosges;117494;60442;57052;116437;83695;47136;26827;391589
1986;89;Yonne;88970;46073;42897;90212;65127;44451;28358;317118
1986;90;Territoire de Belfort;40215;21053;19162;42692;28871;13981;7179;132938
1986;91;Essonne;323845;166055;157790;348866;237352;75153;41157;1026373
1986;92;Hauts-de-Seine;349600;176945;172655;482544;326015;150490;78692;1387341
1986;93;Seine-Saint-Denis;404222;206611;197611;474900;299826;114023;54685;1347656
1986;94;Val-de-Marne;329919;167574;162345;416303;276299;115986;62227;1200734
1986;95;Val-d'Oise;315046;161098;153948;334780;212876;74118;37796;974616
1987;01;Ain;135637;69663;65974;139430;98240;48805;27199;449311
1987;02;Aisne;165908;85248;80660;164173;111013;62914;32578;536586
1987;03;Allier;90604;46380;44224;98557;84410;56601;33999;364171
1987;04;Alpes-de-Haute-Provence;31584;16208;15376;35999;30305;18808;10330;127026
1987;05;Hautes-Alpes;29175;15271;13904;33284;24484;15476;7971;110390
1987;06;Alpes-Maritimes;208241;106449;101792;256455;221870;153170;95873;935609
1987;07;Ardèche;73712;38098;35614;76705;62737;39874;22702;275730
1987;08;Ardennes;93755;48164;45591;90445;63870;33677;17946;299693
1987;09;Ariège;31437;16231;15206;36290;30741;23188;14805;136461
1987;10;Aube;84030;43309;40721;88139;62561;35121;20931;290782
1987;11;Aude;68879;35901;32978;77851;65995;48082;28279;289086
1987;12;Aveyron;67049;34428;32621;71916;63016;44778;26917;273676
1987;13;Bouches-du-Rhône;477857;244551;233306;529914;407047;218721;108703;1742242
1987;14;Calvados;190743;96966;93777;192642;123153;68146;33152;607836
1987;15;Cantal;41562;21297;20265;44595;35926;24541;13764;160388
1987;16;Charente;90864;46603;44261;98310;75923;47661;28330;341088
1987;17;Charente-Maritime;138472;71322;67150;144740;115614;78953;43431;521210
1987;18;Cher;85382;43653;41729;92452;71722;44447;26959;320962
1987;19;Corrèze;56200;29076;27124;64509;54920;40521;23812;239962
1987;21;Côte-d'Or;144918;73068;71850;153810;102117;54918;31051;486814
1987;22;Côtes-d'Armor;149509;76848;72661;145387;119482;83096;40973;538447
1987;23;Creuse;28691;14808;13883;33320;30839;24820;17300;134970
1987;24;Dordogne;91034;47001;44033;101420;88631;65839;36724;383648
1987;25;Doubs;152135;77656;74479;154242;103333;48970;23681;482361
1987;26;Drôme;116877;60224;56653;118931;92130;51512;27617;407067
1987;27;Eure;155776;80060;75716;154689;101957;52058;26615;491095
1987;28;Eure-et-Loir;118571;60953;57618;117082;78986;43573;24525;382737
1987;29;Finistère;235066;120806;114260;240783;180825;118651;58866;834191
1987;2A;Corse-du-Sud;28103;14421;13682;33954;27138;16930;8177;114302
1987;2B;Haute-Corse;31590;16093;15497;40034;31302;18937;9748;131611
1987;30;Gard;150110;77151;72959;163842;129155;79181;40991;563279
1987;31;Haute-Garonne;237944;120413;117531;294612;194602;102439;55184;884781
1987;32;Gers;40035;20859;19176;46581;41589;28826;17580;174611
1987;33;Gironde;326670;166236;160434;371079;253655;147667;81074;1180145
1987;34;Hérault;202686;102983;99703;228961;166645;107083;56728;762103
1987;35;Ille-et-Vilaine;241955;122915;119040;243934;160429;89853;42375;778546
1987;36;Indre;59722;30686;29036;65177;54087;37155;23648;239789
1987;37;Indre-et-Loire;151852;76478;75374;158203;111091;64011;37181;522338
1987;38;Isère;297602;152530;145072;311939;217430;102512;51220;980703
1987;39;Jura;71104;36526;34578;70862;54364;32972;18404;247706
1987;40;Landes;77289;40109;37180;85957;70873;46436;26137;306692
1987;41;Loir-et-Cher;82615;42358;40257;85907;65169;42121;26203;302015
1987;42;Loire;217324;111492;105832;213847;166952;93902;50447;742472
1987;43;Haute-Loire;55065;28411;26654;57524;46327;29910;17860;206686
1987;44;Loire-Atlantique;324423;165718;158705;318178;217699;115914;56767;1032981
1987;45;Loiret;166498;84768;81730;174255;118873;65459;36706;561791
1987;46;Lot;36212;18702;17510;40798;35713;26810;15244;154777
1987;47;Lot-et-Garonne;77089;39568;37521;81956;69957;47429;26017;302448
1987;48;Lozère;18652;9574;9078;20550;15888;11387;6904;73381
1987;49;Maine-et-Loire;229752;117334;112418;208456;138497;77532;42999;697236
1987;50;Manche;139357;71619;67738;137909;101555;64439;30750;474010
1987;51;Marne;171807;87605;84202;179365;113320;56463;30726;551681
1987;52;Haute-Marne;62063;32072;29991;61112;43931;25555;14090;206751
1987;53;Mayenne;85268;43844;41424;79898;57234;34703;18360;275463
1987;54;Meurthe-et-Moselle;214167;109224;104943;230840;154531;78055;38813;716406
1987;55;Meuse;59123;30704;28419;59125;41575;25156;13757;198736
1987;56;Morbihan;180439;93189;87250;176402;131369;82302;37933;608445
1987;57;Moselle;306153;157688;148465;331846;226840;106745;44316;1015900
1987;58;Nièvre;58837;30385;28452;64409;52119;36970;23568;235903
1987;59;Nord;832409;425589;406820;790123;507768;261048;128457;2519805
1987;60;Oise;228073;117106;110967;227214;145727;64642;33900;699556
1987;61;Orne;87344;44907;42437;84741;63671;39062;20365;295183
1987;62;Pas-de-Calais;465443;238197;227246;430770;291294;166115;74798;1428420
1987;63;Puy-de-Dôme;164181;83429;80752;183661;134971;74354;38789;595956
1987;64;Pyrénées-Atlantiques;148064;75690;72374;163636;129733;80686;46540;568659
1987;65;Hautes-Pyrénées;54838;28459;26379;63971;54290;34792;19142;227033
1987;66;Pyrénées-Orientales;85320;43823;41497;92146;80567;60865;31424;350322
1987;67;Bas-Rhin;269922;136730;133192;314293;203344;98574;52396;938529
1987;68;Haut-Rhin;191049;98157;92892;215747;148260;69490;37020;661566
1987;69;Rhône;430125;218447;211678;472040;332581;154810;81201;1470757
1987;70;Haute-Saône;69257;35943;33314;66364;49633;29315;16819;231388
1987;71;Saône-et-Loire;155197;79940;75257;158577;126812;78197;44803;563586
1987;72;Sarthe;153541;78872;74669;152012;107731;64075;35503;512862
1987;73;Savoie;94772;48467;46305;104540;75021;39020;20043;333396
1987;74;Haute-Savoie;157779;81232;76547;178600;118329;53337;25264;533309
1987;75;Paris;437798;219890;217908;788324;494493;270426;173118;2164159
1987;76;Seine-Maritime;376100;192034;184066;384093;253813;132889;67737;1214632
1987;77;Seine-et-Marne;325779;167428;158351;326998;212927;81206;46496;993406
1987;78;Yvelines;399991;205449;194542;411007;300995;99163;50095;1261251
1987;79;Deux-Sèvres;98445;50647;47798;98388;74317;46183;26863;344196
1987;80;Somme;170538;86867;83671;167564;111245;63733;33978;547058
1987;81;Tarn;86653;44864;41789;93256;79451;51633;30874;341867
1987;82;Tarn-et-Garonne;50328;26016;24312;55378;44118;29486;16818;196128
1987;83;Var;194430;100230;94200;216489;180865;120757;58659;771200
1987;84;Vaucluse;125425;64487;60938;133419;104229;58438;29856;451367
1987;85;Vendée;150147;77476;72671;144998;104107;67144;34793;501189
1987;86;Vienne;106403;54218;52185;112367;79010;49266;29660;376706
1987;87;Haute-Vienne;86238;43982;42256;101394;80884;53448;33968;355932
1987;88;Vosges;115638;59486;56152;115105;84154;47481;27054;389432
1987;89;Yonne;88838;45978;42860;90068;66251;45005;28549;318711
1987;90;Territoire de Belfort;39761;20790;18971;42448;29135;14158;7297;132799
1987;91;Essonne;323539;165838;157701;349684;245429;77645;42103;1038400
1987;92;Hauts-de-Seine;347400;176038;171362;480552;329011;151867;79649;1388479
1987;93;Seine-Saint-Denis;406462;207859;198603;477190;304740;116473;55287;1360152
1987;94;Val-de-Marne;326960;166174;160786;415661;280384;117607;63122;1203734
1987;95;Val-d'Oise;320273;163970;156303;338152;220071;76419;38513;993428
1988;01;Ain;136974;70321;66653;140479;101318;49551;27962;456284
1988;02;Aisne;164813;84535;80278;163020;112155;63883;33004;536875
1988;03;Allier;88731;45346;43385;97171;84399;56366;34438;361105
1988;04;Alpes-de-Haute-Provence;31474;16150;15324;36004;30494;19090;10516;127578
1988;05;Hautes-Alpes;29181;15265;13916;33330;24834;15592;8183;111120
1988;06;Alpes-Maritimes;209971;107345;102626;258403;225409;154728;98341;946852
1988;07;Ardèche;73184;37787;35397;76395;63397;40092;23260;276328
1988;08;Ardennes;92717;47511;45206;89312;64172;34009;18284;298494
1988;09;Ariège;31229;16122;15107;36086;30786;23167;14986;136254
1988;10;Aube;82990;42667;40323;86832;63245;35161;21141;289369
1988;11;Aude;69572;36291;33281;79024;67035;48846;29049;293526
1988;12;Aveyron;65936;33869;32067;71363;62993;44596;27712;272600
1988;13;Bouches-du-Rhône;475883;243513;232370;529444;413177;220708;111555;1750767
1988;14;Calvados;189723;96590;93133;192114;125899;69474;34224;611434
1988;15;Cantal;40857;20933;19924;44374;36109;24588;14136;160064
1988;16;Charente;90217;46329;43888;97983;76840;47969;29087;342096
1988;17;Charente-Maritime;137439;70694;66745;143785;117420;80302;44815;523761
1988;18;Cher;84466;43169;41297;91798;72766;44633;27474;321137
1988;19;Corrèze;55444;28625;26819;63892;54913;40477;24344;239070
1988;21;Côte-d'Or;143490;72444;71046;153553;104486;55559;31940;489028
1988;22;Côtes-d'Armor;148084;75968;72116;143793;120586;83949;42214;538626
1988;23;Creuse;28154;14532;13622;32858;30567;24714;17387;133680
1988;24;Dordogne;90316;46611;43705;100943;89028;66306;37565;384158
1988;25;Doubs;150338;76785;73553;153161;106001;49929;24639;484068
1988;26;Drôme;116598;60013;56585;118798;93614;52074;28299;409383
1988;27;Eure;157580;80961;76619;155984;105427;53327;27402;499720
1988;28;Eure-et-Loir;119291;61314;57977;117163;81163;44298;25269;387184
1988;29;Finistère;232934;119725;113209;240119;182437;119260;60707;835457
1988;2A;Corse-du-Sud;28406;14628;13778;34180;27528;17061;8405;115580
1988;2B;Haute-Corse;31302;15859;15443;39991;31299;19017;9986;131595
1988;30;Gard;150889;77490;73399;165155;131384;80194;42045;569667
1988;31;Haute-Garonne;237059;120141;116918;298599;200246;104251;56972;897127
1988;32;Gers;39623;20604;19019;46243;41629;28973;17993;174461
1988;33;Gironde;325195;165577;159618;372661;260193;149272;83094;1190415
1988;34;Hérault;201911;102549;99362;230619;170530;107879;58077;769016
1988;35;Ille-et-Vilaine;240023;122099;117924;245225;164321;91033;44148;784750
1988;36;Indre;58689;30100;28589;64681;54440;37253;24073;239136
1988;37;Indre-et-Loire;149874;75555;74319;157743;113110;64296;38242;523265
1988;38;Isère;297301;152506;144795;313333;222639;104417;52767;990457
1988;39;Jura;70295;36168;34127;70233;54879;33096;18818;247321
1988;40;Landes;76647;39720;36927;85658;71478;47079;26636;307498
1988;41;Loir-et-Cher;82092;42065;40027;85577;66321;42534;26884;303408
1988;42;Loire;215103;110497;104606;212216;169252;95119;51749;743439
1988;43;Haute-Loire;54571;28117;26454;57177;46774;30096;18033;206651
1988;44;Loire-Atlantique;322246;164492;157754;316374;222361;117876;58566;1037423
1988;45;Loiret;167205;85136;82069;174243;122438;66470;37837;568193
1988;46;Lot;35928;18573;17355;40703;35939;27096;15716;155382
1988;47;Lot-et-Garonne;76880;39425;37455;81867;70632;48038;26657;304074
1988;48;Lozère;18454;9482;8972;20360;16132;11365;7089;73400
1988;49;Maine-et-Loire;227384;116023;111361;208008;140800;78261;44099;698552
1988;50;Manche;139087;71426;67661;137767;102530;65304;31728;476416
1988;51;Marne;170588;87052;83536;179061;116528;57168;31661;555006
1988;52;Haute-Marne;61111;31511;29600;60554;44358;25713;14449;206185
1988;53;Mayenne;84751;43549;41202;79510;58049;35103;19049;276462
1988;54;Meurthe-et-Moselle;210751;107491;103260;228041;156197;79056;39876;713921
1988;55;Meuse;58316;30252;28064;58278;41758;25332;14013;197697
1988;56;Morbihan;179752;92759;86993;176326;133181;83557;39404;612220
1988;57;Moselle;301692;155351;146341;328749;226967;108640;45631;1011679
1988;58;Nièvre;58224;30003;28221;63447;52424;37232;23815;235142
1988;59;Nord;825587;422040;403547;783763;514188;263262;130799;2517599
1988;60;Oise;228873;117356;111517;227524;150591;65750;34532;707270
1988;61;Orne;86110;44258;41852;83728;63963;39597;20894;294292
1988;62;Pas-de-Calais;463082;236833;226249;427542;293212;167752;76548;1428136
1988;63;Puy-de-Dôme;162200;82478;79722;183000;137465;75448;39863;597976
1988;64;Pyrénées-Atlantiques;147174;75322;71852;164104;131623;81599;47963;572463
1988;65;Hautes-Pyrénées;53841;27906;25935;63441;54021;34923;19541;225767
1988;66;Pyrénées-Orientales;85966;44082;41884;93254;82056;61862;32591;355729
1988;67;Bas-Rhin;267169;135466;131703;315370;205942;100212;53422;942115
1988;68;Haut-Rhin;190342;97681;92661;215860;150383;71169;37737;665491
1988;69;Rhône;427736;217105;210631;472064;340356;157335;83797;1481288
1988;70;Haute-Saône;68487;35462;33025;65545;50100;29431;17023;230586
1988;71;Saône-et-Loire;153358;78921;74437;157162;127995;78940;45700;563155
1988;72;Sarthe;151376;77602;73774;150594;109119;64374;36418;511881
1988;73;Savoie;95177;48735;46442;105670;77103;39979;20821;338750
1988;74;Haute-Savoie;158606;81603;77003;179682;122457;54514;26270;541529
1988;75;Paris;433785;218217;215568;783631;502773;264009;174534;2158732
1988;76;Seine-Maritime;373610;190658;182952;382117;258475;134143;69602;1217947
1988;77;Seine-et-Marne;334162;171755;162407;332712;224555;83306;47927;1022662
1988;78;Yvelines;401606;206126;195480;410594;310644;101945;51588;1276377
1988;79;Deux-Sèvres;97582;50186;47396;98270;75320;46559;27781;345512
1988;80;Somme;168542;85804;82738;167176;112742;64359;34550;547369
1988;81;Tarn;85719;44361;41358;92814;79797;52019;31612;341961
1988;82;Tarn-et-Garonne;50184;25937;24247;55594;44666;29751;17281;197476
1988;83;Var;197082;101683;95399;218537;185656;123540;60984;785799
1988;84;Vaucluse;125801;64677;61124;133722;106363;59203;30703;455792
1988;85;Vendée;148841;76686;72155;144213;105635;68144;35819;502652
1988;86;Vienne;105116;53569;51547;112442;80317;49742;30555;378172
1988;87;Haute-Vienne;84979;43370;41609;100320;81534;53179;34455;354467
1988;88;Vosges;114655;58896;55759;113969;85215;47848;27679;389366
1988;89;Yonne;88685;45779;42906;89425;67382;45315;28973;319780
1988;90;Territoire de Belfort;39623;20666;18957;42289;29836;14433;7528;133709
1988;91;Essonne;325163;166535;158628;352134;255697;80500;43598;1057092
1988;92;Hauts-de-Seine;345345;175179;170166;477024;333410;151867;81736;1389382
1988;93;Seine-Saint-Denis;407163;208032;199131;474312;310019;117544;56334;1365372
1988;94;Val-de-Marne;325514;165460;160054;413031;286307;118865;64580;1208297
1988;95;Val-d'Oise;325514;166534;158980;340820;228056;78574;39679;1012643
1989;01;Ain;138131;70845;67286;141183;104387;50419;28667;462787
1989;02;Aisne;163698;83866;79832;161557;113639;64902;33400;537196
1989;03;Allier;87280;44590;42690;96322;84444;56756;34881;359683
1989;04;Alpes-de-Haute-Provence;31694;16252;15442;36237;30930;19470;10828;129159
1989;05;Hautes-Alpes;29381;15341;14040;33261;25342;15700;8454;112138
1989;06;Alpes-Maritimes;212123;108761;103362;260136;229406;156042;100734;958441
1989;07;Ardèche;72513;37447;35066;76153;63834;40426;23734;276660
1989;08;Ardennes;91684;46934;44750;88281;64657;34640;18496;297758
1989;09;Ariège;31163;16066;15097;35899;30909;23350;15138;136459
1989;10;Aube;82161;42202;39959;85990;64347;35527;21379;289404
1989;11;Aude;69800;36293;33507;79522;67641;49280;29672;295915
1989;12;Aveyron;65027;33351;31676;70532;63067;44550;28410;271586
1989;13;Bouches-du-Rhône;472853;242101;230752;528127;417875;222440;113993;1755288
1989;14;Calvados;188467;95899;92568;191327;129009;70770;35342;614915
1989;15;Cantal;40148;20564;19584;43920;36202;24783;14405;159458
1989;16;Charente;89414;45905;43509;97142;77595;48400;29609;342160
1989;17;Charente-Maritime;136314;70019;66295;142544;119051;81560;45979;525448
1989;18;Cher;83569;42717;40852;91113;73938;44901;27958;321479
1989;19;Corrèze;54739;28219;26520;63235;55105;40696;24812;238587
1989;21;Côte-d'Or;142064;71783;70281;153408;106947;56208;32810;491437
1989;22;Côtes-d'Armor;146497;74997;71500;142028;121803;85021;43438;538787
1989;23;Creuse;27651;14296;13355;32428;30308;24755;17512;132654
1989;24;Dordogne;89806;46345;43461;100414;89635;67049;38425;385329
1989;25;Doubs;148091;75638;72453;151722;108458;50890;25534;484695
1989;26;Drôme;116214;59690;56524;118404;94935;52545;28978;411076
1989;27;Eure;158530;81381;77149;156589;108842;54424;27993;506378
1989;28;Eure-et-Loir;119958;61539;58419;116863;83420;45183;25934;391358
1989;29;Finistère;230729;118529;112200;239187;184339;120255;62379;836889
1989;2A;Corse-du-Sud;28764;14860;13904;34193;28061;17092;8640;116750
1989;2B;Haute-Corse;31428;15872;15556;39314;31559;19231;10072;131604
1989;30;Gard;152046;78055;73991;166171;133783;81521;43232;576753
1989;31;Haute-Garonne;236561;120124;116437;302814;206219;106167;58731;910492
1989;32;Gers;39245;20348;18897;45958;41752;29172;18381;174508
1989;33;Gironde;324046;165033;159013;373972;266937;151387;84876;1201218
1989;34;Hérault;202858;103054;99804;233436;174760;110120;59578;780752
1989;35;Ille-et-Vilaine;238257;121219;117038;246100;168789;92398;45711;791255
1989;36;Indre;57757;29637;28120;64147;54736;37390;24560;238590
1989;37;Indre-et-Loire;148554;74982;73572;157779;115532;65112;39303;526280
1989;38;Isère;297585;152683;144902;315167;228110;106522;54439;1001823
1989;39;Jura;69649;35830;33819;69942;55645;33541;19225;248002
1989;40;Landes;76423;39605;36818;85444;72319;47953;27292;309431
1989;41;Loir-et-Cher;81524;41696;39828;85227;67328;43188;27468;304735
1989;42;Loire;212844;109229;103615;210683;171389;96040;53220;744176
1989;43;Haute-Loire;54136;27851;26285;56824;46996;30414;18278;206648
1989;44;Loire-Atlantique;320929;163669;157260;315109;228383;119634;60695;1044750
1989;45;Loiret;167392;85149;82243;174031;126044;67637;38904;574008
1989;46;Lot;35710;18455;17255;40314;36216;27252;16114;155606
1989;47;Lot-et-Garonne;76601;39243;37358;81441;71056;48553;27371;305022
1989;48;Lozère;18231;9376;8855;20046;16315;11306;7269;73167
1989;49;Maine-et-Loire;225867;115297;110570;208027;143454;79376;45557;702281
1989;50;Manche;138524;71125;67399;137355;103287;66364;32535;478065
1989;51;Marne;168665;86026;82639;178304;119324;57792;32451;556536
1989;52;Haute-Marne;60141;31003;29138;59776;44722;25905;14767;205311
1989;53;Mayenne;84185;43235;40950;79010;58892;35414;19822;277323
1989;54;Meurthe-et-Moselle;207789;106022;101767;225894;158180;80448;40970;713281
1989;55;Meuse;57766;29940;27826;57505;42007;25597;14290;197165
1989;56;Morbihan;178839;92217;86622;176177;135223;84947;40764;615950
1989;57;Moselle;298817;153880;144937;325791;228971;111455;46852;1011886
1989;58;Nièvre;57573;29633;27940;62406;52826;37415;24096;234316
1989;59;Nord;821320;420073;401247;779696;522474;267084;133403;2523977
1989;60;Oise;230003;118093;111910;227931;155538;67211;35156;715839
1989;61;Orne;85108;43658;41450;82504;64696;40185;21449;293942
1989;62;Pas-de-Calais;459616;235066;224550;423661;295771;169201;78081;1426330
1989;63;Puy-de-Dôme;159577;81178;78399;181602;139870;76428;40853;598330
1989;64;Pyrénées-Atlantiques;146148;74860;71288;163892;133412;82746;49191;575389
1989;65;Hautes-Pyrénées;53066;27411;25655;62996;54280;35087;19957;225386
1989;66;Pyrénées-Orientales;86346;44228;42118;93944;83014;62572;33586;359462
1989;67;Bas-Rhin;265111;134534;130577;316121;209653;102200;54329;947414
1989;68;Haut-Rhin;189447;97092;92355;215218;152421;73187;38188;668461
1989;69;Rhône;426101;216348;209753;473708;346813;160409;86324;1493355
1989;70;Haute-Saône;67814;35129;32685;64784;50781;29540;17289;230208
1989;71;Saône-et-Loire;151091;77747;73344;155403;128876;79587;46578;561535
1989;72;Sarthe;149714;76717;72997;149815;110737;65117;37547;512930
1989;73;Savoie;96811;49593;47218;108124;80050;41414;21962;348361
1989;74;Haute-Savoie;159156;81794;77362;180301;126589;55540;27239;548825
1989;75;Paris;430119;216554;213565;780577;511620;258833;175306;2156455
1989;76;Seine-Maritime;370739;189084;181655;380042;262950;135619;71294;1220644
1989;77;Seine-et-Marne;341165;175319;165846;337599;235075;85358;49086;1048283
1989;78;Yvelines;403038;206868;196170;410263;319906;104322;53230;1290759
1989;79;Deux-Sèvres;96221;49438;46783;97660;76394;46933;28489;345697
1989;80;Somme;166550;84918;81632;166298;114779;65139;34983;547749
1989;81;Tarn;85171;44013;41158;92270;80067;52716;32257;342481
1989;82;Tarn-et-Garonne;50193;25890;24303;55611;45170;30101;17740;198815
1989;83;Var;199790;103173;96617;220616;189550;126181;63465;799602
1989;84;Vaucluse;126436;64926;61510;134334;108487;60101;31643;461001
1989;85;Vendée;147840;76090;71750;143728;107860;69326;37047;505801
1989;86;Vienne;103710;52941;50769;112232;81552;50256;31390;379140
1989;87;Haute-Vienne;83881;42838;41043;99588;82325;53423;34980;354197
1989;88;Vosges;113029;58088;54941;112618;85890;48360;28159;388056
1989;89;Yonne;88485;45645;42840;88909;68709;46034;29231;321368
1989;90;Territoire de Belfort;39216;20364;18852;41993;30318;14681;7750;133958
1989;91;Essonne;325151;166280;158871;352562;264109;83058;44917;1069797
1989;92;Hauts-de-Seine;344590;174941;169649;473229;337481;152200;83477;1390977
1989;93;Seine-Saint-Denis;408877;208949;199928;471987;315410;119243;57251;1372768
1989;94;Val-de-Marne;323971;164781;159190;410535;291385;120393;65701;1211985
1989;95;Val-d'Oise;330061;168737;161324;342520;235743;80785;40616;1029725
1990;01;Ain;139298;71324;67974;142812;107851;51385;29305;470651
1990;02;Aisne;162241;82965;79276;159798;115301;66035;33521;536896
1990;03;Allier;85633;43758;41875;95503;84518;57023;35275;357952
1990;04;Alpes-de-Haute-Provence;32010;16442;15568;36578;31381;19799;11143;130911
1990;05;Hautes-Alpes;29569;15403;14166;33317;25823;15826;8730;113265
1990;06;Alpes-Maritimes;215109;110205;104904;263257;232984;157821;103209;972380
1990;07;Ardèche;72027;37147;34880;76142;64524;40801;24157;277651
1990;08;Ardennes;90220;46128;44092;86988;65214;35136;18592;296150
1990;09;Ariège;31068;16020;15048;35791;31076;23381;15365;136681
1990;10;Aube;81304;41753;39551;85041;65400;35838;21555;289138
1990;11;Aude;70250;36464;33786;80252;68278;49919;30218;298917
1990;12;Aveyron;63814;32756;31058;70063;63134;44379;29018;270408
1990;13;Bouches-du-Rhône;470370;240887;229483;525915;421957;223891;115931;1758064
1990;14;Calvados;186832;95082;91750;190510;132368;72120;36287;618117
1990;15;Cantal;39331;20123;19208;43619;36336;24847;14707;158840
1990;16;Charente;88321;45334;42987;96427;78381;48788;30124;342041
1990;17;Charente-Maritime;134963;69251;65712;141691;120654;82779;47099;527186
1990;18;Cher;82551;42144;40407;90482;74890;45300;28264;321487
1990;19;Corrèze;53968;27783;26185;62618;55433;40810;25222;238051
1990;21;Côte-d'Or;140325;70870;69455;153146;109584;56834;33582;493471
1990;22;Côtes-d'Armor;144313;73763;70550;140692;123019;85987;44432;538443
1990;23;Creuse;27121;14030;13091;32121;29990;24802;17551;131585
1990;24;Dordogne;89277;45972;43305;100142;90337;67655;39279;386690
1990;25;Doubs;145244;74190;71054;150401;110536;51791;26292;484264
1990;26;Drôme;116144;59634;56510;118568;96221;53296;29600;413829
1990;27;Eure;159577;81914;77663;157386;112269;55675;28558;513465
1990;28;Eure-et-Loir;120542;61768;58774;116738;85881;46089;26433;395683
1990;29;Finistère;228199;117062;111137;238713;186530;120812;64112;838366
1990;2A;Corse-du-Sud;29340;15227;14113;34348;28416;17572;8776;118452
1990;2B;Haute-Corse;31317;15904;15413;38877;31527;19280;10192;131193
1990;30;Gard;153361;78616;74745;167789;136652;82899;44281;584982
1990;31;Haute-Garonne;236462;120108;116354;307735;212365;107885;60669;925116
1990;32;Gers;38892;20120;18772;45792;41858;29504;18700;174746
1990;33;Gironde;322923;164528;158395;376080;274384;153481;86672;1213540
1990;34;Hérault;204223;103894;100329;236860;180042;112314;61203;794642
1990;35;Ille-et-Vilaine;236230;120337;115893;247390;173092;93790;47283;797785
1990;36;Indre;56660;29031;27629;63590;54974;37509;24876;237609
1990;37;Indre-et-Loire;146813;74173;72640;158141;117965;66018;40213;529150
1990;38;Isère;298116;152991;145125;318256;233911;108987;55968;1015238
1990;39;Jura;68999;35435;33564;69811;56319;33936;19642;248707
1990;40;Landes;76092;39340;36752;85443;73204;48774;27994;311507
1990;41;Loir-et-Cher;80847;41325;39522;84815;68396;43946;27865;305869
1990;42;Loire;210770;108016;102754;209651;173986;97163;54531;746101
1990;43;Haute-Loire;53618;27568;26050;56609;47397;30641;18393;206658
1990;44;Loire-Atlantique;318047;162280;155767;314691;234137;120940;62724;1050539
1990;45;Loiret;167195;85009;82186;174410;129692;68871;39842;580010
1990;46;Lot;35529;18354;17175;39912;36555;27493;16481;155970
1990;47;Lot-et-Garonne;76243;39118;37125;81101;71651;48832;27970;305797
1990;48;Lozère;17916;9198;8718;19826;16438;11295;7388;72863
1990;49;Maine-et-Loire;223289;113943;109346;207810;146402;80364;46803;704668
1990;50;Manche;137940;70790;67150;136991;104279;67228;33141;479579
1990;51;Marne;166598;84951;81647;177443;121936;58721;32938;557636
1990;52;Haute-Marne;58976;30344;28632;58972;45100;26022;14969;204039
1990;53;Mayenne;83287;42752;40535;78529;59839;35671;20422;277748
1990;54;Meurthe-et-Moselle;204239;104211;100028;223578;160020;81758;41772;711367
1990;55;Meuse;56967;29502;27465;56622;42372;25950;14371;196282
1990;56;Morbihan;177690;91524;86166;176398;137389;86139;42107;619723
1990;57;Moselle;295016;151806;143210;322407;231128;114166;47797;1010514
1990;58;Nièvre;56848;29207;27641;61565;53085;37706;24246;233450
1990;59;Nord;815052;416896;398156;776517;531507;270726;135693;2529495
1990;60;Oise;230915;118550;112365;228546;160799;68667;35660;724587
1990;61;Orne;83873;42999;40874;81560;65273;40680;21808;293194
1990;62;Pas-de-Calais;457839;234074;223765;422421;300490;171593;79865;1432208
1990;63;Puy-de-Dôme;156878;79798;77080;180296;142332;77163;41642;598311
1990;64;Pyrénées-Atlantiques;144966;74271;70695;164054;135074;83767;50215;578076
1990;65;Hautes-Pyrénées;52244;26925;25319;62529;54516;35291;20339;224919
1990;66;Pyrénées-Orientales;86888;44463;42425;94784;84029;63638;34425;363764
1990;67;Bas-Rhin;262554;133187;129367;316910;213509;104128;55057;952158
1990;68;Haut-Rhin;188143;96383;91760;214191;154714;75064;38540;670652
1990;69;Rhône;423976;215624;208352;476698;354061;163363;89015;1507113
1990;70;Haute-Saône;66893;34696;32197;64046;51536;29577;17426;229478
1990;71;Saône-et-Loire;148838;76548;72290;153516;129619;80130;47257;559360
1990;72;Sarthe;147567;75446;72121;148857;112599;65899;38358;513280
1990;73;Savoie;95806;49117;46689;107365;80761;41717;22440;348089
1990;74;Haute-Savoie;162972;83668;79304;185059;133178;57864;28662;567735
1990;75;Paris;425574;214535;211039;776471;519423;253597;175082;2150147
1990;76;Seine-Maritime;367136;187251;179885;377718;267973;137055;72622;1222504
1990;77;Seine-et-Marne;348965;179233;169732;343779;246387;87946;50129;1077206
1990;78;Yvelines;404037;207093;196944;411402;327986;107072;54579;1305076
1990;79;Deux-Sèvres;95015;48807;46208;97158;77315;47426;29113;346027
1990;80;Somme;164193;83729;80464;165294;116812;65979;35207;547485
1990;81;Tarn;84528;43578;40950;91792;80571;53259;32796;342946
1990;82;Tarn-et-Garonne;50094;25783;24311;55781;45771;30566;18083;200295
1990;83;Var;203009;104638;98371;223462;193810;129517;65916;815714
1990;84;Vaucluse;127262;65455;61807;135488;110524;61121;32515;466910
1990;85;Vendée;146816;75517;71299;143427;109972;70660;38087;508962
1990;86;Vienne;102062;52193;49869;112318;82771;50791;32021;379963
1990;87;Haute-Vienne;82556;42167;40389;99025;83305;53616;35322;353824
1990;88;Vosges;111237;57126;54111;110880;86859;48749;28403;386128
1990;89;Yonne;88335;45503;42832;88379;70086;46907;29411;323118
1990;90;Territoire de Belfort;38649;19967;18682;41722;30860;14807;7940;133978
1990;91;Essonne;325363;166281;159082;354098;271971;85786;46027;1083245
1990;92;Hauts-de-Seine;342866;174196;168670;468892;341069;151839;84750;1389416
1990;93;Seine-Saint-Denis;410115;209378;200737;469474;320206;120880;57901;1378576
1990;94;Val-de-Marne;321688;163732;157956;408128;295092;121746;66792;1213446
1990;95;Val-d'Oise;334679;171094;163585;344988;243448;82908;41530;1047553
1990;971;Guadeloupe;132209;66984;65225;116927;63409;28247;11052;351844
1990;972;Martinique;124866;63543;61323;118174;67925;33582;13859;358406
1990;973;Guyane;49987;25325;24662;39505;17666;4676;1517;113351
1990;974;La Réunion (*);238712;120615;118097;204727;103001;38781;12607;597828
1991;01;Ain;140309;71829;68480;142927;111129;53693;28924;476982
1991;02;Aisne;160712;82202;78510;157963;117180;68649;32759;537263
1991;03;Allier;84007;42913;41094;94170;84949;58746;34560;356432
1991;04;Alpes-de-Haute-Provence;32083;16426;15657;36450;31894;20414;11016;131857
1991;05;Hautes-Alpes;29692;15433;14259;33162;26413;16313;8613;114193
1991;06;Alpes-Maritimes;216365;110791;105574;264571;236217;161373;102805;981331
1991;07;Ardèche;71479;36775;34704;75649;65552;42143;23865;278688
1991;08;Ardennes;88867;45366;43501;86103;65979;36601;18126;295676
1991;09;Ariège;30847;15892;14955;35553;31297;24071;15004;136772
1991;10;Aube;80628;41373;39255;84408;66608;37320;21154;290118
1991;11;Aude;70040;36306;33734;80107;68972;51696;29800;300615
1991;12;Aveyron;62699;32240;30459;69079;63459;45404;28473;269114
1991;13;Bouches-du-Rhône;467311;239294;228017;526586;428542;229833;115782;1768054
1991;14;Calvados;184409;93812;90597;190914;135436;75093;35928;621780
1991;15;Cantal;38519;19682;18837;42940;36772;25511;14563;158305
1991;16;Charente;87221;44774;42447;95445;79394;50547;29637;342244
1991;17;Charente-Maritime;133815;68668;65147;141337;123010;85998;46472;530632
1991;18;Cher;81358;41548;39810;89520;75894;46916;27586;321274
1991;19;Corrèze;52994;27268;25726;62092;55829;41818;24777;237510
1991;21;Côte-d'Or;138601;70060;68541;153261;111705;58833;33131;495531
1991;22;Côtes-d'Armor;141848;72541;69307;139765;124331;88684;43585;538213
1991;23;Creuse;26581;13728;12853;31678;29926;25412;16957;130554
1991;24;Dordogne;88205;45433;42772;99278;91089;69707;38860;387139
1991;25;Doubs;143426;73282;70144;150444;112608;54015;26014;486507
1991;26;Drôme;115938;59498;56440;118282;98374;55250;29175;417019
1991;27;Eure;158686;81479;77207;156741;115562;58060;28429;517478
1991;28;Eure-et-Loir;120085;61510;58575;116022;88397;47948;26123;398575
1991;29;Finistère;224457;115194;109263;238220;188461;123988;63275;838401
1991;2A;Corse-du-Sud;29324;15177;14147;33976;28734;18087;8742;118863
1991;2B;Haute-Corse;31450;15977;15473;38918;32231;19947;10250;132796
1991;30;Gard;152875;78324;74551;167316;138987;85721;43846;588745
1991;31;Haute-Garonne;236343;120141;116202;313232;217498;111380;60424;938877
1991;32;Gers;38381;19852;18529;45549;42110;30458;18401;174899
1991;33;Gironde;320794;163526;157268;377728;281181;158594;85660;1223957
1991;34;Hérault;204580;104211;100369;239925;184093;116567;60722;805887
1991;35;Ille-et-Vilaine;234557;119513;115044;249800;176459;97389;46924;805129
1991;36;Indre;55664;28502;27162;62978;55293;38716;24458;237109
1991;37;Indre-et-Loire;144865;73274;71591;158668;120243;68070;39798;531644
1991;38;Isère;296945;152398;144547;320035;238845;113343;55400;1024568
1991;39;Jura;68331;35068;33263;69613;57093;35126;19267;249430
1991;40;Landes;75628;39063;36565;85036;74504;50463;27656;313287
1991;41;Loir-et-Cher;80058;40893;39165;84388;69774;45559;27438;307217
1991;42;Loire;207202;106174;101028;207973;175768;100367;53562;744872
1991;43;Haute-Loire;52925;27264;25661;56107;47906;31717;17957;206612
1991;44;Loire-Atlantique;315527;160898;154629;315604;240197;125468;62170;1058966
1991;45;Loiret;166619;84767;81852;174542;133319;71754;39354;585588
1991;46;Lot;35208;18155;17053;39572;36864;28343;16275;156262
1991;47;Lot-et-Garonne;75261;38649;36612;80261;72203;50094;27651;305470
1991;48;Lozère;17634;9046;8588;19654;16582;11534;7246;72650
1991;49;Maine-et-Loire;220106;112442;107664;207988;149456;83155;46315;707020
1991;50;Manche;136342;69950;66392;135783;105216;69928;32551;479820
1991;51;Marne;164089;83745;80344;177196;124388;60903;32430;559006
1991;52;Haute-Marne;57986;29941;28045;58023;45662;27017;14645;203333
1991;53;Mayenne;82250;42272;39978;78219;60621;37031;20134;278255
1991;54;Meurthe-et-Moselle;201243;102741;98502;222875;161503;85108;41029;711758
1991;55;Meuse;56235;29110;27125;56045;42904;26862;13997;196043
1991;56;Morbihan;175202;90222;84980;175602;139733;89330;41873;621740
1991;57;Moselle;290921;149717;141204;320928;233501;118871;47627;1011848
1991;58;Nièvre;55943;28731;27212;60613;53701;38948;23466;232671
1991;59;Nord;806251;412297;393954;774150;537914;281197;132112;2531624
1991;60;Oise;230810;118446;112364;228035;166470;71757;35204;732276
1991;61;Orne;82527;42323;40204;80824;66199;42266;21345;293161
1991;62;Pas-de-Calais;452947;231535;221412;420269;304498;178065;77990;1433769
1991;63;Puy-de-Dôme;154176;78503;75673;179154;144340;79832;40866;598368
1991;64;Pyrénées-Atlantiques;143355;73383;69972;163942;137226;86264;49868;580655
1991;65;Hautes-Pyrénées;51387;26483;24904;61990;55135;36213;20301;225026
1991;66;Pyrénées-Orientales;86689;44323;42366;95731;85035;65730;34440;367625
1991;67;Bas-Rhin;261175;132550;128625;319002;218099;107742;54302;960320
1991;68;Haut-Rhin;187500;96087;91413;213809;157580;78461;37760;675110
1991;69;Rhône;422033;214626;207407;479237;358323;170024;87812;1517429
1991;70;Haute-Saône;65662;33990;31672;63426;52375;30536;16929;228928
1991;71;Saône-et-Loire;146324;75219;71105;151700;130998;83071;46318;558411
1991;72;Sarthe;145451;74365;71086;148637;114481;68287;37754;514610
1991;73;Savoie;95616;49024;46592;107729;82672;43351;22288;351656
1991;74;Haute-Savoie;164707;84624;80083;185778;138089;60580;28680;577834
1991;75;Paris;423595;213405;210190;773569;522330;255775;170643;2145912
1991;76;Seine-Maritime;363788;185636;178152;376566;272758;142066;71841;1227019
1991;77;Seine-et-Marne;351007;180328;170679;345835;256415;92338;49640;1095235
1991;78;Yvelines;403268;206670;196598;409424;334972;112894;54367;1314925
1991;79;Deux-Sèvres;93443;48136;45307;96313;78130;49374;28541;345801
1991;80;Somme;161669;82360;79309;165076;118736;68334;34312;548127
1991;81;Tarn;83628;43080;40548;90688;80975;55018;32236;342545
1991;82;Tarn-et-Garonne;49899;25590;24309;55751;46589;31560;17814;201613
1991;83;Var;203959;105115;98844;224022;197478;133957;66397;825813
1991;84;Vaucluse;127780;65727;62053;135645;113054;63414;32358;472251
1991;85;Vendée;145798;74981;70817;143179;112175;73730;37867;512749
1991;86;Vienne;100638;51559;49079;113062;84217;52381;31563;381861
1991;87;Haute-Vienne;81240;41514;39726;98698;84358;55106;34416;353818
1991;88;Vosges;109474;56191;53283;109560;87683;50585;27763;385065
1991;89;Yonne;87738;45166;42572;87822;71799;48381;28883;324623
1991;90;Territoire de Belfort;38170;19656;18514;41581;31396;15453;7839;134439
1991;91;Essonne;324637;165927;158710;354883;277726;90944;45468;1093658
1991;92;Hauts-de-Seine;342612;174127;168485;468605;341542;156432;83178;1392369
1991;93;Seine-Saint-Denis;409412;209111;200301;465780;323497;125481;56783;1380953
1991;94;Val-de-Marne;319859;162704;157155;406416;297203;126284;65392;1215154
1991;95;Val-d'Oise;335561;171545;164016;343914;249832;87014;41029;1057350
1991;971;Guadeloupe;131360;66568;64792;117177;65557;28906;11536;354536
1991;972;Martinique;123739;62918;60821;117598;69715;34358;14364;359774
1991;973;Guyane;51818;26254;25564;40435;18643;4839;1592;117327
1991;974;La Réunion;250553;126682;123871;204208;103252;38039;11785;607837
1992;01;Ain;140454;71965;68489;143853;113926;56070;28254;482557
1992;02;Aisne;158814;81124;77690;156963;118932;71329;31717;537755
1992;03;Allier;82287;42107;40180;93227;85326;61000;33355;355195
1992;04;Alpes-de-Haute-Provence;32033;16389;15644;36442;32309;21211;10744;132739
1992;05;Hautes-Alpes;29551;15269;14282;33141;26945;16792;8488;114917
1992;06;Alpes-Maritimes;217773;111541;106232;266137;238696;165846;100799;989251
1992;07;Ardèche;70809;36432;34377;75405;66449;43638;23137;279438
1992;08;Ardennes;87150;44512;42638;85436;66458;38206;17375;294625
1992;09;Ariège;30570;15743;14827;35328;31620;24923;14429;136870
1992;10;Aube;79672;40836;38836;84146;67675;38632;20606;290731
1992;11;Aude;69481;35935;33546;79916;69405;53540;28703;301045
1992;12;Aveyron;61475;31690;29785;68637;63840;47149;27434;268535
1992;13;Bouches-du-Rhône;464536;237941;226595;528367;434246;236583;113619;1777351
1992;14;Calvados;181989;92621;89368;191399;138163;78284;35244;625079
1992;15;Cantal;37457;19179;18278;42428;36843;26459;14033;157220
1992;16;Charente;85858;44072;41786;94801;80230;52590;28763;342242
1992;17;Charente-Maritime;131964;67768;64196;141556;124883;89897;45131;533431
1992;18;Cher;79997;40903;39094;88948;76542;48803;26752;321042
1992;19;Corrèze;51908;26730;25178;61654;56120;43261;23999;236942
1992;21;Côte-d'Or;136440;69033;67407;153973;113728;61116;32306;497563
1992;22;Côtes-d'Armor;138863;71123;67740;138870;125436;91760;42325;537254
1992;23;Creuse;25988;13390;12598;31293;29906;26206;16255;129648
1992;24;Dordogne;86727;44663;42064;98701;91552;72318;37768;387066
1992;25;Doubs;141861;72518;69343;150777;114223;56458;25637;488956
1992;26;Drôme;115227;59199;56028;118321;99984;57356;28557;419445
1992;27;Eure;158025;81117;76908;156918;118776;60714;28044;522477
1992;28;Eure-et-Loir;119216;61022;58194;116059;90673;49775;25600;401323
1992;29;Finistère;220594;113321;107273;238278;190049;128097;61439;838457
1992;2A;Corse-du-Sud;29243;15097;14146;33672;29056;18520;8585;119076
1992;2B;Haute-Corse;31135;15860;15275;38596;32462;20294;10135;132622
1992;30;Gard;152483;78049;74434;167665;141459;89161;42655;593423
1992;31;Haute-Garonne;236594;120450;116144;320210;222975;115869;59481;955129
1992;32;Gers;37638;19465;18173;44912;42283;31524;17745;174102
1992;33;Gironde;318177;162303;155874;380023;287604;163912;83662;1233378
1992;34;Hérault;205016;104501;100515;243598;188069;121083;59551;817317
1992;35;Ille-et-Vilaine;232641;118726;113915;252571;179909;101329;45855;812305
1992;36;Indre;54428;27832;26596;62611;55649;40136;23643;236467
1992;37;Indre-et-Loire;143043;72342;70701;159715;122455;70511;38976;534700
1992;38;Isère;295818;151780;144038;322918;243688;118248;54395;1035067
1992;39;Jura;67495;34630;32865;69612;57654;36464;18596;249821
1992;40;Landes;74865;38673;36192;85219;75651;52638;26888;315261
1992;41;Loir-et-Cher;79115;40450;38665;84124;71001;47474;26768;308482
1992;42;Loire;203695;104340;99355;207385;177084;103955;52164;744283
1992;43;Haute-Loire;52169;26881;25288;56002;48275;32886;17307;206639
1992;44;Loire-Atlantique;312779;159526;153253;318466;245742;131288;60708;1068983
1992;45;Loiret;165948;84415;81533;175520;136400;74710;38451;591029
1992;46;Lot;34776;17897;16879;39542;37219;29612;15831;156980
1992;47;Lot-et-Garonne;74127;38019;36108;79514;72903;51553;26897;304994
1992;48;Lozère;17263;8868;8395;19564;16772;11809;6982;72390
1992;49;Maine-et-Loire;217169;110999;106170;209010;152280;86724;45086;710269
1992;50;Manche;134154;68810;65344;135032;105626;72780;31816;479408
1992;51;Marne;161485;82350;79135;177261;126759;63253;31651;560409
1992;52;Haute-Marne;56642;29302;27340;57289;45879;28068;14174;202052
1992;53;Mayenne;81073;41695;39378;78123;61397;38562;19546;278701
1992;54;Meurthe-et-Moselle;198483;101423;97060;223428;162992;88756;39955;713614
1992;55;Meuse;55312;28565;26747;55662;43258;27927;13517;195676
1992;56;Morbihan;172362;88691;83671;175542;141485;93157;40911;623457
1992;57;Moselle;286889;147670;139219;320148;235663;124235;46599;1013534
1992;58;Nièvre;54858;28138;26720;59891;54211;40200;22571;231731
1992;59;Nord;796971;407658;389313;775763;544343;294287;125479;2536843
1992;60;Oise;230170;118159;112011;228706;171141;75160;34465;739642
1992;61;Orne;81313;41785;39528;80349;66876;44078;20698;293314
1992;62;Pas-de-Calais;447011;228633;218378;418987;307901;184964;75490;1434353
1992;63;Puy-de-Dôme;151217;77012;74205;178545;146487;82722;39377;598348
1992;64;Pyrénées-Atlantiques;141836;72718;69118;164366;138774;89784;48589;583349
1992;65;Hautes-Pyrénées;50571;25995;24576;61463;55453;37511;19825;224823
1992;66;Pyrénées-Orientales;86221;44156;42065;96148;85654;67881;33753;369657
1992;67;Bas-Rhin;259928;132089;127839;321823;222192;112262;52674;968879
1992;68;Haut-Rhin;186302;95399;90903;214094;159991;82224;36474;679085
1992;69;Rhône;420588;213779;206809;484390;362163;177245;85804;1530190
1992;70;Haute-Saône;64453;33361;31092;63105;53225;31592;16282;228657
1992;71;Saône-et-Loire;143732;73929;69803;150536;132315;86264;44882;557729
1992;72;Sarthe;143455;73382;70073;149069;116222;70938;36968;516652
1992;73;Savoie;95289;48886;46403;108602;84269;45317;21804;355281
1992;74;Haute-Savoie;165665;85108;80557;187188;142132;63419;28379;586783
1992;75;Paris;420010;211622;208388;773874;523022;258679;164343;2139928
1992;76;Seine-Maritime;359922;183653;176269;376162;277260;147293;70331;1230968
1992;77;Seine-et-Marne;353209;181539;171670;350264;265917;97140;48692;1115222
1992;78;Yvelines;402012;205928;196084;410735;340956;119043;53439;1326185
1992;79;Deux-Sèvres;91779;47284;44495;95809;79238;51359;27646;345831
1992;80;Somme;159158;81130;78028;165268;120596;70642;33221;548885
1992;81;Tarn;82447;42512;39935;90013;81406;57252;31146;342264
1992;82;Tarn-et-Garonne;49708;25488;24220;55693;47420;32788;17321;202930
1992;83;Var;204864;105455;99409;225702;201167;139449;65984;837166
1992;84;Vaucluse;127375;65442;61933;135806;114820;65585;31653;475239
1992;85;Vendée;144069;74200;69869;143059;114370;77181;36941;515620
1992;86;Vienne;99392;50955;48437;113977;85760;54319;30635;384083
1992;87;Haute-Vienne;80041;41011;39030;98746;85282;57115;33147;354331
1992;88;Vosges;107701;55282;52419;108750;88675;52497;27145;384768
1992;89;Yonne;86947;44757;42190;87678;73337;50219;28061;326242
1992;90;Territoire de Belfort;37785;19491;18294;41522;31817;16081;7687;134892
1992;91;Essonne;324334;165832;158502;357971;282668;96403;44598;1105974
1992;92;Hauts-de-Seine;341363;173344;168019;470081;341620;160923;80923;1394910
1992;93;Seine-Saint-Denis;408705;208545;200160;464325;326620;130172;55086;1384908
1992;94;Val-de-Marne;318401;162040;156361;406394;299266;130931;63458;1218450
1992;95;Val-d'Oise;335977;171759;164218;344710;255535;91291;40186;1067699
1992;971;Guadeloupe;130567;66177;64390;117496;67785;29585;12049;357482
1992;972;Martinique;122667;62325;60342;117143;71563;35155;14892;361420
1992;973;Guyane;53720;27219;26501;41391;19679;5008;1671;121469
1992;974;La Réunion;253056;128001;125055;208493;107577;38904;12303;620333
1993;01;Ain;140123;71710;68413;145053;117006;58328;27734;488244
1993;02;Aisne;156620;80080;76540;156030;121042;73916;30611;538219
1993;03;Allier;80261;41049;39212;92616;85791;62860;32296;353824
1993;04;Alpes-de-Haute-Provence;32143;16459;15684;36434;32882;22028;10553;134040
1993;05;Hautes-Alpes;29298;15154;14144;32974;27426;17285;8393;115376
1993;06;Alpes-Maritimes;218195;111747;106448;266422;240918;169345;98815;993695
1993;07;Ardèche;69883;36007;33876;75441;67329;45177;22433;280263
1993;08;Ardennes;85660;43855;41805;85180;67164;39929;16671;294604
1993;09;Ariège;30040;15488;14552;35128;31941;25695;13828;136632
1993;10;Aube;78543;40332;38211;84048;68751;39827;20190;291359
1993;11;Aude;68700;35580;33120;79772;70120;55237;27864;301693
1993;12;Aveyron;60127;31021;29106;68237;63946;48719;26699;267728
1993;13;Bouches-du-Rhône;462111;236747;225364;530039;440335;243333;112207;1788025
1993;14;Calvados;180100;91495;88605;191086;141498;81250;34753;628687
1993;15;Cantal;36329;18647;17682;42001;37052;27379;13688;156449
1993;16;Charente;84231;43221;41010;94280;81347;54486;28037;342381
1993;17;Charente-Maritime;129814;66706;63108;141890;126906;93101;44182;535893
1993;18;Cher;78254;40041;38213;88298;77286;50310;26109;320257
1993;19;Corrèze;50808;26170;24638;61151;56560;44484;23305;236308
1993;21;Côte-d'Or;134783;68206;66577;154200;115671;63273;31592;499519
1993;22;Côtes-d'Armor;136170;69814;66356;138477;126695;94910;41183;537435
1993;23;Creuse;25439;13101;12338;31061;29959;26954;15563;128976
1993;24;Dordogne;85219;43832;41387;98226;92390;74479;36913;387227
1993;25;Doubs;140199;71642;68557;150963;115994;58583;25370;491109
1993;26;Drôme;114615;58952;55663;118612;101754;59442;28152;422575
1993;27;Eure;156425;80296;76129;156929;121746;62990;27733;525823
1993;28;Eure-et-Loir;117833;60296;57537;115904;93240;51344;25207;403528
1993;29;Finistère;217140;111539;105601;238354;191864;132332;59982;839672
1993;2A;Corse-du-Sud;29036;15009;14027;33640;29508;18899;8511;119594
1993;2B;Haute-Corse;31112;15863;15249;38790;33109;20888;10102;134001
1993;30;Gard;152266;77946;74320;167792;144243;92311;42043;598655
1993;31;Haute-Garonne;238450;121481;116969;324808;228501;120363;58624;970746
1993;32;Gers;36808;19039;17769;44547;42481;32622;17277;173735
1993;33;Gironde;316209;161260;154949;381626;293804;169327;82126;1243092
1993;34;Hérault;206256;105033;101223;246241;192500;125419;58781;829197
1993;35;Ille-et-Vilaine;230789;117672;113117;254978;183374;105216;45098;819455
1993;36;Indre;53239;27281;25958;62194;56017;41491;22890;235831
1993;37;Indre-et-Loire;141573;71457;70116;160144;124970;73091;38369;538147
1993;38;Isère;294941;151188;143753;324789;248536;122691;53720;1044677
1993;39;Jura;66527;34175;32352;69507;58358;37749;18074;250215
1993;40;Landes;73911;38148;35763;85495;76852;54661;26207;317126
1993;41;Loir-et-Cher;77834;39861;37973;84327;72197;49277;26163;309798
1993;42;Loire;200529;102715;97814;206730;178589;107210;51009;744067
1993;43;Haute-Loire;51273;26454;24819;55904;48617;33941;16644;206379
1993;44;Loire-Atlantique;310261;158269;151992;321333;251569;136811;59627;1079601
1993;45;Loiret;164756;83886;80870;176299;139485;77665;37721;595926
1993;46;Lot;34287;17610;16677;39290;37657;30666;15311;157211
1993;47;Lot-et-Garonne;72651;37271;35380;79006;73478;53076;26368;304579
1993;48;Lozère;17040;8765;8275;19608;17146;12202;6767;72763
1993;49;Maine-et-Loire;214317;109567;104750;209558;155556;90278;44108;713817
1993;50;Manche;132146;67860;64286;134329;106603;75415;31384;479877
1993;51;Marne;159030;81178;77852;177495;129125;65482;30921;562053
1993;52;Haute-Marne;55138;28489;26649;56814;46289;28878;13763;200882
1993;53;Mayenne;79703;41049;38654;78492;62212;40201;19117;279725
1993;54;Meurthe-et-Moselle;196165;100293;95872;223168;164820;92546;38793;715492
1993;55;Meuse;54300;28029;26271;55561;43842;28907;13099;195709
1993;56;Morbihan;169549;87231;82318;175885;143543;96971;40212;626160
1993;57;Moselle;282743;145557;137186;319447;238669;129494;45501;1015854
1993;58;Nièvre;53644;27477;26167;59373;54501;41426;21812;230756
1993;59;Nord;787813;402994;384819;776232;551600;306007;119777;2541429
1993;60;Oise;228925;117425;111500;229495;176121;77931;33985;746457
1993;61;Orne;79902;41061;38841;80268;67779;45829;20308;294086
1993;62;Pas-de-Calais;440457;225363;215094;418702;312710;190761;73723;1436353
1993;63;Puy-de-Dôme;148716;75814;72902;178186;148717;85491;38215;599325
1993;64;Pyrénées-Atlantiques;140278;71932;68346;164386;140447;92609;47746;585466
1993;65;Hautes-Pyrénées;49580;25396;24184;61108;55780;38711;19497;224676
1993;66;Pyrénées-Orientales;85952;43969;41983;96755;86762;69837;33410;372716
1993;67;Bas-Rhin;259444;131893;127551;324147;226849;117297;50873;978610
1993;68;Haut-Rhin;185359;95009;90350;214404;163365;86043;35186;684357
1993;69;Rhône;419396;213090;206306;487790;365954;183667;84169;1540976
1993;70;Haute-Saône;63175;32726;30449;63012;53971;32633;15786;228577
1993;71;Saône-et-Loire;140691;72456;68235;149479;133726;89006;43689;556591
1993;72;Sarthe;141197;72253;68944;149699;118062;73439;36270;518667
1993;73;Savoie;94837;48684;46153;109157;85823;47190;21477;358484
1993;74;Haute-Savoie;165947;85242;80705;188907;146179;66321;28275;595629
1993;75;Paris;416586;209681;206905;772261;524122;260412;159094;2132475
1993;76;Seine-Maritime;355669;181535;174134;375525;282143;151857;69127;1234321
1993;77;Seine-et-Marne;353500;181463;172037;353618;274604;101404;48053;1131179
1993;78;Yvelines;399196;204452;194744;411266;345971;124522;52859;1333814
1993;79;Deux-Sèvres;89725;46256;43469;95433;80127;53311;26938;345534
1993;80;Somme;156842;79944;76898;165452;122712;72765;32476;550247
1993;81;Tarn;81169;41936;39233;89574;81852;59580;30227;342402
1993;82;Tarn-et-Garonne;49132;25260;23872;55386;47933;33923;16871;203245
1993;83;Var;204999;105601;99398;227288;204395;144423;65791;846896
1993;84;Vaucluse;127061;65253;61808;136163;116583;67867;31169;478843
1993;85;Vendée;142052;73188;68864;143217;116799;80829;36077;518974
1993;86;Vienne;98261;50303;47958;114600;87310;56141;29787;386099
1993;87;Haute-Vienne;78828;40332;38496;98499;86343;58700;32048;354418
1993;88;Vosges;105751;54365;51386;108177;89719;54430;26382;384459
1993;89;Yonne;85969;44289;41680;87654;75011;51837;27268;327739
1993;90;Territoire de Belfort;37444;19350;18094;41515;32302;16728;7521;135510
1993;91;Essonne;323002;165281;157721;360123;286324;101910;44041;1115400
1993;92;Hauts-de-Seine;339605;172355;167250;470351;341911;164417;79177;1395461
1993;93;Seine-Saint-Denis;406599;207418;199181;462882;329321;134696;53929;1387427
1993;94;Val-de-Marne;316341;160999;155342;406696;301243;134942;61936;1221158
1993;95;Val-d'Oise;335527;171541;163986;345204;260856;95349;39564;1076500
1993;971;Guadeloupe;129802;65801;64001;117896;70104;30285;12594;360681
1993;972;Martinique;121649;61760;59889;116805;73472;35976;15442;363344
1993;973;Guyane;55696;28223;27473;42375;20773;5186;1756;125786
1993;974;La Réunion;255371;129205;126166;212373;112502;40009;12775;633030
1994;01;Ain;139286;71287;67999;145208;119558;59792;27291;491135
1994;02;Aisne;154288;78909;75379;154892;123086;75994;29666;537926
1994;03;Allier;78324;40021;38303;92086;86274;64192;31565;352441
1994;04;Alpes-de-Haute-Provence;32173;16496;15677;36485;33473;22693;10392;135216
1994;05;Hautes-Alpes;29317;15150;14167;33047;28092;17769;8464;116689
1994;06;Alpes-Maritimes;218494;111892;106602;266876;243859;172109;97441;998779
1994;07;Ardèche;68955;35506;33449;75184;68509;46300;21949;280897
1994;08;Ardennes;84239;43205;41034;84786;68015;41210;16010;294260
1994;09;Ariège;29784;15358;14426;34896;32297;26168;13468;136613
1994;10;Aube;77582;39880;37702;83837;70050;40697;19802;291968
1994;11;Aude;68321;35335;32986;79409;71045;56410;27384;302569
1994;12;Aveyron;58910;30398;28512;67737;64316;50000;26062;267025
1994;13;Bouches-du-Rhône;459048;235254;223794;530003;445647;248146;111378;1794222
1994;14;Calvados;177604;90197;87407;190942;144749;83406;34481;631182
1994;15;Cantal;35154;18075;17079;41559;37431;28048;13382;155574
1994;16;Charente;82489;42337;40152;93495;82396;55834;27536;341750
1994;17;Charente-Maritime;128083;65840;62243;141594;129230;95632;43721;538260
1994;18;Cher;76744;39248;37496;87604;77958;51420;25568;319294
1994;19;Corrèze;49744;25644;24100;60744;57025;45484;22830;235827
1994;21;Côte-d'Or;133052;67305;65747;154112;117597;65108;31060;500929
1994;22;Côtes-d'Armor;133417;68399;65018;137860;128104;96699;40713;536793
1994;23;Creuse;24868;12813;12055;30828;29899;27425;14939;127959
1994;24;Dordogne;83891;43044;40847;97458;93636;75761;36368;387114
1994;25;Doubs;138346;70645;67701;151191;117669;60427;25179;492812
1994;26;Drôme;113676;58441;55235;118435;103539;61080;27896;424626
1994;27;Eure;155018;79567;75451;156556;124948;64861;27608;528991
1994;28;Eure-et-Loir;116521;59607;56914;115774;95453;52661;24884;405293
1994;29;Finistère;213948;109934;104014;238123;194407;134880;59207;840565
1994;2A;Corse-du-Sud;28802;14932;13870;33440;29759;19268;8408;119677
1994;2B;Haute-Corse;31572;16118;15454;39571;34331;21725;10101;137300
1994;30;Gard;152037;77781;74256;167407;147270;94408;41774;602896
1994;31;Haute-Garonne;237995;121156;116839;327540;232411;123093;58071;979110
1994;32;Gers;36162;18701;17461;44004;42728;33549;16751;173194
1994;33;Gironde;312738;159453;153285;382979;299421;173039;81049;1249226
1994;34;Hérault;206876;105400;101476;248663;196942;128832;58255;839568
1994;35;Ille-et-Vilaine;228976;116622;112354;257186;186973;108238;44724;826097
1994;36;Indre;51982;26586;25396;61626;56407;42229;22333;234577
1994;37;Indre-et-Loire;139673;70481;69192;160650;127254;75108;37878;540563
1994;38;Isère;293053;150439;142614;326213;253224;126427;53015;1051932
1994;39;Jura;65625;33612;32013;69330;59097;38458;17784;250294
1994;40;Landes;73092;37810;35282;85461;78141;56116;25820;318630
1994;41;Loir-et-Cher;76678;39295;37383;84228;73207;50700;25659;310472
1994;42;Loire;196507;100684;95823;205877;180127;109929;50219;742659
1994;43;Haute-Loire;50629;26132;24497;55778;49045;34841;16215;206508
1994;44;Loire-Atlantique;307234;156787;150447;323546;257192;140935;58947;1087854
1994;45;Loiret;163532;83317;80215;176824;142584;80045;37210;600195
1994;46;Lot;33853;17383;16470;39249;38179;31417;14996;157694
1994;47;Lot-et-Garonne;71329;36614;34715;78457;74148;54216;25894;304044
1994;48;Lozère;16779;8643;8136;19579;17498;12440;6636;72932
1994;49;Maine-et-Loire;211041;107851;103190;210634;158706;93162;43494;717037
1994;50;Manche;129896;66775;63121;133604;107877;77244;31158;479779
1994;51;Marne;156634;79930;76704;177643;131460;67231;30389;563357
1994;52;Haute-Marne;53843;27831;26012;56107;46933;29545;13463;199891
1994;53;Mayenne;78561;40515;38046;78536;63125;41445;18902;280569
1994;54;Meurthe-et-Moselle;193627;98929;94698;222583;167205;95359;37744;716518
1994;55;Meuse;53212;27485;25727;55236;44635;29705;12690;195478
1994;56;Morbihan;166539;85665;80874;175245;145686;99851;39807;627128
1994;57;Moselle;279148;143603;135545;317493;242285;134182;44481;1017589
1994;58;Nièvre;52702;27044;25658;58600;55337;42431;21076;230146
1994;59;Nord;777695;397716;379979;777423;560248;314682;114930;2544978
1994;60;Oise;227269;116664;110605;229675;180788;80180;33450;751362
1994;61;Orne;78667;40466;38201;79886;68719;47057;20047;294376
1994;62;Pas-de-Calais;434023;222149;211874;418108;317892;194207;72575;1436805
1994;63;Puy-de-Dôme;145870;74297;71573;177759;150691;87749;37423;599492
1994;64;Pyrénées-Atlantiques;138666;71269;67397;163956;142217;94849;47106;586794
1994;65;Hautes-Pyrénées;48650;24962;23688;60339;56157;39462;19226;223834
1994;66;Pyrénées-Orientales;85694;43853;41841;97008;87734;71122;33296;374854
1994;67;Bas-Rhin;258826;131647;127179;325928;231775;121693;49148;987370
1994;68;Haut-Rhin;184400;94495;89905;214045;166583;89393;33942;688363
1994;69;Rhône;416415;211421;204994;489354;369046;188566;82763;1546144
1994;70;Haute-Saône;62010;32029;29981;62979;54895;33313;15351;228548
1994;71;Saône-et-Loire;137829;71017;66812;148264;135181;91159;42738;555171
1994;72;Sarthe;139077;71212;67865;149777;120192;75469;35950;520465
1994;73;Savoie;94074;48321;45753;109179;87398;48463;21189;360303
1994;74;Haute-Savoie;165574;85142;80432;189126;149425;68328;28131;600584
1994;75;Paris;413361;207904;205457;773672;526766;261177;154880;2129856
1994;76;Seine-Maritime;351228;179269;171959;374668;287019;155348;68511;1236774
1994;77;Seine-et-Marne;354084;181830;172254;356807;283383;104876;47840;1146990
1994;78;Yvelines;396618;203129;193489;411082;350749;129260;52559;1340268
1994;79;Deux-Sèvres;87876;45360;42516;94894;81270;54700;26441;345181
1994;80;Somme;154277;78617;75660;165875;124854;74406;31747;551159
1994;81;Tarn;80150;41398;38752;88812;82610;61228;29509;342309
1994;82;Tarn-et-Garonne;48712;24983;23729;55091;48764;34725;16562;203854
1994;83;Var;205199;105693;99506;228159;208341;148488;66116;856303
1994;84;Vaucluse;126987;65211;61776;136218;118523;69818;30837;482383
1994;85;Vendée;140009;72099;67910;143467;119449;83753;35835;522513
1994;86;Vienne;96971;49486;47485;115301;89126;57609;29163;388170
1994;87;Haute-Vienne;77602;39676;37926;98433;87265;60133;31311;354744
1994;88;Vosges;103898;53466;50432;107692;90998;55959;25735;384282
1994;89;Yonne;85033;43860;41173;87480;76714;53021;26659;328907
1994;90;Territoire de Belfort;37123;19189;17934;41626;32749;17255;7387;136140
1994;91;Essonne;321386;164371;157015;361009;289971;106286;43451;1122103
1994;92;Hauts-de-Seine;338867;171895;166972;472077;343252;166936;78025;1399157
1994;93;Seine-Saint-Denis;404962;206441;198521;460808;332627;138407;52983;1389787
1994;94;Val-de-Marne;314509;160019;154490;405807;302963;138039;60896;1222214
1994;95;Val-d'Oise;334581;171139;163442;344806;265753;98428;39280;1082848
1994;971;Guadeloupe;129096;65459;63637;118369;72509;31010;13156;364140
1994;972;Martinique;120686;61223;59463;116589;75442;36820;16017;365554
1994;973;Guyane;57746;29265;28481;43390;21932;5369;1845;130282
1994;974;La Réunion;257197;130328;126869;215540;117638;41397;13321;645093
1995;01;Ain;139266;71297;67969;144996;122405;61197;27263;495127
1995;02;Aisne;152767;78223;74544;153222;125346;77602;29387;538324
1995;03;Allier;76970;39440;37530;90782;87056;65145;31105;351058
1995;04;Alpes-de-Haute-Provence;32295;16608;15687;36287;34114;23259;10437;136392
1995;05;Hautes-Alpes;29321;15115;14206;32833;28682;18207;8487;117530
1995;06;Alpes-Maritimes;218558;111927;106631;264742;245410;173257;96735;998702
1995;07;Ardèche;68314;35134;33180;74763;69543;47122;21745;281487
1995;08;Ardennes;82817;42508;40309;83770;68844;42159;15778;293368
1995;09;Ariège;29566;15314;14252;34533;32742;26459;13196;136496
1995;10;Aube;76916;39432;37484;83204;71101;41672;19682;292575
1995;11;Aude;68234;35205;33029;78582;72170;57261;27157;303404
1995;12;Aveyron;58013;29895;28118;66987;64717;51129;25627;266473
1995;13;Bouches-du-Rhône;457907;234556;223351;528538;451543;252033;112181;1802202
1995;14;Calvados;176014;89442;86572;189665;148045;85332;34682;633738
1995;15;Cantal;34134;17571;16563;40910;37859;28523;13204;154630
1995;16;Charente;81190;41638;39552;92240;83492;57150;27299;341371
1995;17;Charente-Maritime;126840;65165;61675;140592;131809;97832;43706;540779
1995;18;Cher;75454;38636;36818;86351;78716;52471;25258;318250
1995;19;Corrèze;48875;25231;23644;59970;57746;46245;22586;235422
1995;21;Côte-d'Or;131910;66657;65253;153422;119884;66392;31159;502767
1995;22;Côtes-d'Armor;131553;67419;64134;136610;129616;98424;40806;537009
1995;23;Creuse;24369;12556;11813;30378;29907;27881;14467;127002
1995;24;Dordogne;82838;42541;40297;96169;94872;76946;36116;386941
1995;25;Doubs;137444;70179;67265;150491;119581;62215;25332;495063
1995;26;Drôme;113619;58373;55246;118132;105277;62612;27868;427508
1995;27;Eure;153932;79027;74905;155410;127903;66583;27849;531677
1995;28;Eure-et-Loir;115393;59059;56334;114792;97444;53859;24880;406368
1995;29;Finistère;211611;108683;102928;236433;196981;137201;59072;841298
1995;2A;Corse-du-Sud;28658;14877;13781;32918;30237;19474;8466;119753
1995;2B;Haute-Corse;31687;16162;15525;39538;35072;22181;10185;138663
1995;30;Gard;152072;77783;74289;165641;149870;95829;42001;605413
1995;31;Haute-Garonne;239441;121908;117533;329948;237646;125956;58142;991133
1995;32;Gers;35713;18474;17239;43143;43239;34066;16489;172650
1995;33;Gironde;311657;158854;152803;381964;305608;176174;81062;1256465
1995;34;Hérault;208322;106145;102177;250132;201490;131478;58615;850037
1995;35;Ille-et-Vilaine;227781;115944;111837;258500;190739;110849;44986;832855
1995;36;Indre;51162;26152;25010;60896;56813;43337;21848;234056
1995;37;Indre-et-Loire;139007;70139;68868;160244;129635;76895;37701;543482
1995;38;Isère;292227;149809;142418;326290;258287;129956;53008;1059768
1995;39;Jura;64905;33283;31622;68847;59963;39060;17734;250509
1995;40;Landes;72467;37474;34993;84898;79324;57475;25614;319778
1995;41;Loir-et-Cher;76039;38972;37067;83686;74383;51980;25502;311590
1995;42;Loire;193568;98987;94581;203482;181616;111700;49825;740191
1995;43;Haute-Loire;50018;25828;24190;55387;49682;35470;15954;206511
1995;44;Loire-Atlantique;305451;155968;149483;324335;262597;144697;58953;1096033
1995;45;Loiret;163102;83192;79910;176488;145600;82081;37298;604569
1995;46;Lot;33564;17232;16332;38770;38692;32109;14842;157977
1995;47;Lot-et-Garonne;70704;36329;34375;77468;75026;55296;25816;304310
1995;48;Lozère;16550;8569;7981;19449;17679;12719;6487;72884
1995;49;Maine-et-Loire;208713;106588;102125;210520;162170;95671;43495;720569
1995;50;Manche;128454;66108;62346;132164;109262;78958;31472;480310
1995;51;Marne;154946;79022;75924;176918;133813;69022;30209;564908
1995;52;Haute-Marne;52823;27335;25488;55271;47562;30218;13389;199263
1995;53;Mayenne;77643;40109;37534;78305;64085;42461;18949;281443
1995;54;Meurthe-et-Moselle;191725;97999;93726;220686;169705;97715;37442;717273
1995;55;Meuse;52352;27023;25329;54492;45228;30409;12406;194887
1995;56;Morbihan;164604;84590;80014;174251;147942;102650;40071;629518
1995;57;Moselle;276258;141973;134285;314240;246561;137401;44961;1019421
1995;58;Nièvre;51952;26660;25292;57812;55952;43182;20679;229577
1995;59;Nord;770087;393585;376502;774696;569696;320046;114423;2548948
1995;60;Oise;225892;116003;109889;228881;185002;82350;33548;755673
1995;61;Orne;77518;39885;37633;78949;69520;48277;20004;294268
1995;62;Pas-de-Calais;428462;219238;209224;415476;323235;197104;73121;1437398
1995;63;Puy-de-Dôme;143697;73141;70556;176729;152803;89697;37107;600033
1995;64;Pyrénées-Atlantiques;137735;70896;66839;162656;144042;96975;46818;588226
1995;65;Hautes-Pyrénées;48205;24755;23450;59488;56803;40273;19167;223936
1995;66;Pyrénées-Orientales;85692;43824;41868;97004;88900;72011;33689;377296
1995;67;Bas-Rhin;258800;131577;127223;325227;236782;124692;49431;994932
1995;68;Haut-Rhin;183862;94214;89648;213088;169803;91774;34016;692543
1995;69;Rhône;415372;210855;204517;488701;372397;192436;82576;1551482
1995;70;Haute-Saône;61236;31589;29647;62776;56073;34186;15105;229376
1995;71;Saône-et-Loire;135343;69622;65721;146147;136523;92945;42423;553381
1995;72;Sarthe;137809;70558;67251;149207;122151;77449;35846;522462
1995;73;Savoie;93764;48131;45633;108593;89083;49719;21181;362340
1995;74;Haute-Savoie;166210;85515;80695;189112;153223;70280;28362;607187
1995;75;Paris;410008;206102;203906;770861;527583;260235;151858;2120545
1995;76;Seine-Maritime;348288;177721;170567;371724;291765;158784;68796;1239357
1995;77;Seine-et-Marne;354598;181936;172662;357633;291190;107974;48026;1159421
1995;78;Yvelines;394948;202242;192706;409154;355041;133582;52746;1345471
1995;79;Deux-Sèvres;86470;44631;41839;94014;82539;56114;26119;345256
1995;80;Somme;152138;77403;74735;165388;127128;75822;31677;552153
1995;81;Tarn;79181;40890;38291;87626;83403;62568;29095;341873
1995;82;Tarn-et-Garonne;48400;24839;23561;54421;49691;35349;16407;204268
1995;83;Var;206006;105943;100063;227574;212128;151548;67034;864290
1995;84;Vaucluse;127453;65426;62027;135729;120672;71250;31092;486196
1995;85;Vendée;138147;71105;67042;143005;121900;86364;35834;525250
1995;86;Vienne;96513;49123;47390;115782;91358;59273;28952;391878
1995;87;Haute-Vienne;76452;39094;37358;97864;88159;61141;30902;354518
1995;88;Vosges;102559;52688;49871;106434;92256;57236;25422;383907
1995;89;Yonne;84335;43506;40829;86778;78319;53892;26460;329784
1995;90;Territoire de Belfort;36836;19032;17804;41510;33199;17738;7309;136592
1995;91;Essonne;320870;164024;156846;359975;292928;110375;43499;1127647
1995;92;Hauts-de-Seine;339278;172339;166939;472209;344723;169020;77851;1403081
1995;93;Seine-Saint-Denis;403906;205950;197956;456110;336217;141005;52738;1389976
1995;94;Val-de-Marne;313434;159478;153956;402911;304418;140470;60685;1221918
1995;95;Val-d'Oise;335172;171473;163699;343377;271489;101343;39535;1090916
1995;971;Guadeloupe;128425;65138;63287;118916;75012;31759;13755;367867
1995;972;Martinique;119777;60713;59064;116486;77480;37688;16614;368045
1995;973;Guyane;59875;30348;29527;44434;23161;5559;1939;134968
1995;974;La Réunion;258687;131109;127578;219015;122407;43192;13861;657162
1996;01;Ain;140095;71738;68357;144245;125299;61208;28463;499310
1996;02;Aisne;151540;77599;73941;151033;127658;76725;31061;538017
1996;03;Allier;75992;38976;37016;89074;87762;64302;32246;349376
1996;04;Alpes-de-Haute-Provence;32618;16814;15804;35833;34802;23191;11009;137453
1996;05;Hautes-Alpes;29530;15255;14275;32522;29427;18116;8931;118526
1996;06;Alpes-Maritimes;219343;112275;107068;262644;248048;169788;100331;1000154
1996;07;Ardèche;68330;35118;33212;74130;70796;46717;22865;282838
1996;08;Ardennes;81984;42158;39826;82415;69855;42050;16518;292822
1996;09;Ariège;29462;15233;14229;33831;33302;25895;13729;136219
1996;10;Aube;76436;39222;37214;82116;72121;41289;20419;292381
1996;11;Aude;68516;35338;33178;77693;73386;56372;28563;304530
1996;12;Aveyron;57368;29664;27704;65889;65178;50694;26363;265492
1996;13;Bouches-du-Rhône;458545;234902;223643;525159;457394;250100;118028;1809226
1996;14;Calvados;175865;89235;86630;187880;151785;85222;36917;637669
1996;15;Cantal;33341;17160;16181;40037;38356;28282;13761;153777
1996;16;Charente;80391;41234;39157;90575;84641;56731;28448;340786
1996;17;Charente-Maritime;126620;65008;61612;139189;134432;97275;46319;543835
1996;18;Cher;74585;38184;36401;84707;79497;52087;26037;316913
1996;19;Corrèze;48326;24917;23409;58884;58338;45472;23521;234541
1996;21;Côte-d'Or;131540;66449;65091;151953;122027;65967;32535;504022
1996;22;Côtes-d'Armor;130513;66920;63593;134540;131389;97281;43133;536856
1996;23;Creuse;24063;12409;11654;29812;30170;27400;14914;126359
1996;24;Dordogne;82266;42298;39968;94544;96286;75907;37682;386685
1996;25;Doubs;136873;69840;67033;149379;121454;62546;26596;496848
1996;26;Drôme;113793;58459;55334;116757;107114;62313;29234;429211
1996;27;Eure;153611;78903;74708;153948;131151;66472;29331;534513
1996;28;Eure-et-Loir;114577;58660;55917;113344;99515;53549;25976;406961
1996;29;Finistère;211282;108541;102741;234293;200457;135871;62213;844116
1996;2A;Corse-du-Sud;28420;14744;13676;32170;30521;19184;8870;119165
1996;2B;Haute-Corse;31913;16313;15600;39462;35774;22130;10724;140003
1996;30;Gard;152756;78102;74654;164142;152839;94864;44371;608972
1996;31;Haute-Garonne;242538;123545;118993;331514;243135;125956;61023;1004166
1996;32;Gers;35566;18416;17150;42341;43811;33646;17196;172560
1996;33;Gironde;311754;158823;152931;380110;312133;174050;85380;1263427
1996;34;Hérault;211027;107450;103577;251193;206474;130540;62447;861681
1996;35;Ille-et-Vilaine;227902;116059;111843;259506;194910;110447;47885;840650
1996;36;Indre;50730;25906;24824;59769;57445;42924;22507;233375
1996;37;Indre-et-Loire;138846;70107;68739;159062;132304;76505;39439;546156
1996;38;Isère;293043;150194;142849;325416;263505;130313;55561;1067838
1996;39;Jura;64562;33138;31424;68162;60963;38583;18599;250869
1996;40;Landes;72517;37569;34948;83935;80694;57424;26670;321240
1996;41;Loir-et-Cher;75754;38768;36986;82904;75588;51706;26638;312590
1996;42;Loire;191659;97920;93739;200953;183086;111103;51869;738670
1996;43;Haute-Loire;49843;25718;24125;54745;50602;35182;16523;206895
1996;44;Loire-Atlantique;305389;155881;149508;324316;268535;144464;62316;1105020
1996;45;Loiret;163125;83160;79965;175725;148475;81839;39167;608331
1996;46;Lot;33516;17232;16284;38291;39286;31745;15525;158363
1996;47;Lot-et-Garonne;70283;36119;34164;76087;75851;54755;27088;304064
1996;48;Lozère;16404;8475;7929;19344;17985;12600;6700;73033
1996;49;Maine-et-Loire;207538;105982;101556;209802;165756;95563;45665;724324
1996;50;Manche;127374;65573;61801;130241;110979;78221;33452;480267
1996;51;Marne;153899;78423;75476;175262;136087;68665;31631;565544
1996;52;Haute-Marne;52105;26962;25143;54135;48146;30024;13865;198275
1996;53;Mayenne;77029;39859;37170;78012;64987;42402;19946;282376
1996;54;Meurthe-et-Moselle;190567;97411;93156;217861;172153;97476;39144;717201
1996;55;Meuse;51809;26755;25054;53732;46067;30117;12897;194622
1996;56;Morbihan;163669;84038;79631;172581;150668;102574;42550;632042
1996;57;Moselle;274391;140942;133449;309504;250956;137965;47442;1020258
1996;58;Nièvre;51308;26312;24996;56571;56656;42780;21253;228568
1996;59;Nord;765609;391217;374392;769796;579926;315248;122152;2552731
1996;60;Oise;225932;116165;109767;227623;189581;82569;35209;760914
1996;61;Orne;76575;39470;37105;77770;70244;47779;21148;293516
1996;62;Pas-de-Calais;425283;217719;207564;411585;329555;194970;77407;1438800
1996;63;Puy-de-Dôme;142596;72452;70144;174997;155047;89231;38969;600840
1996;64;Pyrénées-Atlantiques;137357;70723;66634;160732;145983;96485;48502;589059
1996;65;Hautes-Pyrénées;48011;24693;23318;58320;57335;39920;19974;223560
1996;66;Pyrénées-Orientales;86672;44341;42331;96916;90547;71508;35546;381189
1996;67;Bas-Rhin;260551;132611;127940;323196;242298;124934;51576;1002555
1996;68;Haut-Rhin;184347;94529;89818;211224;173584;92194;35435;696784
1996;69;Rhône;416116;211137;204979;486148;376187;191566;86420;1556437
1996;70;Haute-Saône;60571;31272;29299;62048;56788;33889;15808;229104
1996;71;Saône-et-Loire;133446;68648;64798;143745;138167;91901;44296;551555
1996;72;Sarthe;136976;70142;66834;147987;124478;77067;37467;523975
1996;73;Savoie;93648;48067;45581;107806;90771;49581;22181;363987
1996;74;Haute-Savoie;167522;86249;81273;188364;156976;70546;30059;613467
1996;75;Paris;408506;205334;203172;769263;530103;254569;154071;2116512
1996;76;Seine-Maritime;346446;176743;169703;366963;296662;157809;72057;1239937
1996;77;Seine-et-Marne;356112;182590;173522;356477;298681;108500;50057;1169827
1996;78;Yvelines;394621;202148;192473;406286;358956;135094;55582;1350539
1996;79;Deux-Sèvres;85535;44099;41436;92834;83773;55667;27446;345255
1996;80;Somme;150949;76751;74198;164199;129511;75178;33201;553038
1996;81;Tarn;78774;40690;38084;86239;84554;61852;30521;341940
1996;82;Tarn-et-Garonne;48416;24822;23594;53678;50493;34864;17191;204642
1996;83;Var;207573;106623;100950;225883;216259;150558;71232;871505
1996;84;Vaucluse;128336;65921;62415;134630;122483;71122;32759;489330
1996;85;Vendée;136996;70363;66633;142156;124661;86753;37778;528344
1996;86;Vienne;96234;48869;47365;115348;93279;58843;30141;393845
1996;87;Haute-Vienne;75961;38833;37128;96929;89134;60547;31844;354415
1996;88;Vosges;101722;52223;49499;104926;93594;57050;26409;383701
1996;89;Yonne;84049;43390;40659;85922;80029;53276;27454;330730
1996;90;Territoire de Belfort;36808;19048;17760;41106;33694;17783;7584;136975
1996;91;Essonne;321147;164026;157121;357258;295496;112024;45474;1131399
1996;92;Hauts-de-Seine;341177;173276;167901;471371;346780;166828;80793;1406949
1996;93;Seine-Saint-Denis;403631;205766;197865;450315;340132;140672;54918;1389668
1996;94;Val-de-Marne;313126;159385;153741;398923;306579;139364;63153;1221145
1996;95;Val-d'Oise;336255;172000;164255;341086;276898;102178;41392;1097809
1996;971;Guadeloupe;127813;64843;62970;119533;77613;32538;14376;371873
1996;972;Martinique;118918;60227;58691;116498;79583;38582;17237;370818
1996;973;Guyane;62084;31473;30611;45508;24461;5757;2038;139848
1996;974;La Réunion;259835;131718;128117;222506;127120;44470;14984;668915
1997;01;Ain;140999;72264;68735;143846;128419;61294;29643;504201
1997;02;Aisne;150713;77043;73670;148508;130143;75769;32618;537751
1997;03;Allier;75330;38609;36721;87333;88689;63312;33536;348200
1997;04;Alpes-de-Haute-Provence;32988;17047;15941;35310;35410;23081;11584;138373
1997;05;Hautes-Alpes;29697;15317;14380;32160;30178;18046;9352;119433
1997;06;Alpes-Maritimes;220480;112980;107500;260726;250775;167079;103300;1002360
1997;07;Ardèche;68299;35102;33197;73281;72113;46218;23900;283811
1997;08;Ardennes;81186;41817;39369;81179;70752;41733;17325;292175
1997;09;Ariège;29498;15266;14232;33412;33961;25481;14192;136544
1997;10;Aube;76304;39117;37187;81160;73167;41093;20988;292712
1997;11;Aude;68909;35516;33393;76644;74866;55289;29896;305604
1997;12;Aveyron;56889;29448;27441;64998;65570;50340;27230;265027
1997;13;Bouches-du-Rhône;459882;235451;224431;521386;462583;248187;123233;1815271
1997;14;Calvados;176008;89269;86739;186510;155331;85085;38934;641868
1997;15;Cantal;32704;16847;15857;39089;38797;27853;14297;152740
1997;16;Charente;79757;40949;38808;88953;86008;56123;29590;340431
1997;17;Charente-Maritime;126797;65193;61604;137641;137305;96712;48586;547041
1997;18;Cher;74129;38060;36069;82901;80432;51771;26888;316121
1997;19;Corrèze;47797;24683;23114;57800;59095;44479;24596;233767
1997;21;Côte-d'Or;131520;66422;65098;150462;124210;65650;33874;505716
1997;22;Côtes-d'Armor;130409;66915;63494;133182;133556;96754;45423;539324
1997;23;Creuse;23932;12352;11580;29192;30434;26854;15444;125856
1997;24;Dordogne;81934;42131;39803;93108;97872;74988;39491;387393
1997;25;Doubs;136245;69648;66597;147949;123117;62758;27650;497719
1997;26;Drôme;114621;58953;55668;115589;109524;62010;30507;432251
1997;27;Eure;153493;78790;74703;152207;134401;66565;30520;537186
1997;28;Eure-et-Loir;113940;58296;55644;112024;101676;53132;27021;407793
1997;29;Finistère;211256;108522;102734;231855;204208;135032;64724;847075
1997;2A;Corse-du-Sud;28237;14630;13607;31448;30881;18941;9205;118712
1997;2B;Haute-Corse;31917;16373;15544;39024;36185;22212;11047;140385
1997;30;Gard;153905;78612;75293;162349;156107;94118;46502;612981
1997;31;Haute-Garonne;246391;125448;120943;331941;248934;125718;63862;1016846
1997;32;Gers;35555;18410;17145;41428;44217;33371;17830;172401
1997;33;Gironde;312307;159107;153200;377795;318432;172058;89567;1270159
1997;34;Hérault;213409;108724;104685;252090;211531;129490;65750;872270
1997;35;Ille-et-Vilaine;229169;116770;112399;259650;199053;110446;50408;848726
1997;36;Indre;50237;25731;24506;58885;58131;42370;23206;232829
1997;37;Indre-et-Loire;138994;70175;68819;157817;134974;76377;41100;549262
1997;38;Isère;294505;151005;143500;324512;268854;130644;58372;1076887
1997;39;Jura;64122;32941;31181;67243;61887;38077;19330;250659
1997;40;Landes;72592;37588;35004;83198;82086;57261;28013;323150
1997;41;Loir-et-Cher;75622;38724;36898;81978;76940;51531;27589;313660
1997;42;Loire;189688;96934;92754;197860;184168;109854;53717;735287
1997;43;Haute-Loire;49851;25722;24129;54137;51533;34876;17158;207555
1997;44;Loire-Atlantique;305503;155955;149548;324183;274087;144655;65660;1114088
1997;45;Loiret;163500;83344;80156;174777;151465;81737;40890;612369
1997;46;Lot;33590;17268;16322;37766;40035;31435;16248;159074
1997;47;Lot-et-Garonne;70166;36068;34098;74872;76951;54293;28309;304591
1997;48;Lozère;16369;8475;7894;19130;18278;12422;7020;73219
1997;49;Maine-et-Loire;206685;105460;101225;208271;169281;95317;47589;727143
1997;50;Manche;126681;65310;61371;128225;112723;78026;35203;480858
1997;51;Marne;153005;77986;75019;173296;138180;68472;32845;565798
1997;52;Haute-Marne;51450;26638;24812;52848;48781;29817;14346;197242
1997;53;Mayenne;76632;39694;36938;77346;66159;42330;20659;283126
1997;54;Meurthe-et-Moselle;189767;97064;92703;214746;174175;96890;40870;716448
1997;55;Meuse;51269;26462;24807;52915;46950;29749;13455;194338
1997;56;Morbihan;163038;83789;79249;170654;153728;102890;44919;635229
1997;57;Moselle;273318;140224;133094;305102;255244;138596;50249;1022509
1997;58;Nièvre;50732;26044;24688;55335;57404;42068;22084;227623
1997;59;Nord;762011;389359;372652;762486;589477;310747;128787;2553508
1997;60;Oise;225482;115867;109615;225763;193449;82784;36513;763991
1997;61;Orne;75984;39196;36788;76459;71303;47506;22162;293414
1997;62;Pas-de-Calais;423461;217014;206447;407231;335988;193467;80880;1441027
1997;63;Puy-de-Dôme;141922;72151;69771;172915;157709;88197;40993;601736
1997;64;Pyrénées-Atlantiques;137442;70771;66671;159287;148171;96389;50240;591529
1997;65;Hautes-Pyrénées;47842;24648;23194;57082;57955;39591;20639;223109
1997;66;Pyrénées-Orientales;87678;44866;42812;96785;92348;71183;37119;385113
1997;67;Bas-Rhin;262189;133522;128667;320930;247941;124907;53882;1009849
1997;68;Haut-Rhin;185105;94861;90244;209115;177089;92492;37129;700930
1997;69;Rhône;417358;211773;205585;483659;379544;190680;90068;1561309
1997;70;Haute-Saône;60182;31070;29112;61194;57732;33675;16403;229186
1997;71;Saône-et-Loire;131956;67973;63983;140976;139728;90816;45889;549365
1997;72;Sarthe;136889;69990;66899;146873;126917;76869;38903;526451
1997;73;Savoie;94284;48487;45797;106874;92887;49623;23241;366909
1997;74;Haute-Savoie;168840;87017;81823;187727;160582;71128;31686;619963
1997;75;Paris;407830;205025;202805;765871;532263;249644;155261;2110869
1997;76;Seine-Maritime;344713;175894;168819;361556;301220;157064;74593;1239146
1997;77;Seine-et-Marne;356497;182748;173749;354429;304511;109231;51621;1176289
1997;78;Yvelines;393831;201850;191981;402438;362235;136630;58046;1353180
1997;79;Deux-Sèvres;84787;43798;40989;91371;84767;55446;28389;344760
1997;80;Somme;150099;76417;73682;162750;131825;74593;34403;553670
1997;81;Tarn;78492;40546;37946;85028;85622;61202;31772;342116
1997;82;Tarn-et-Garonne;48548;24943;23605;53019;51246;34323;18072;205208
1997;83;Var;209984;107734;102250;225234;221598;150803;74968;882587
1997;84;Vaucluse;129434;66408;63026;133530;124624;71036;34356;492980
1997;85;Vendée;136207;69907;66300;141123;127508;87049;39610;531497
1997;86;Vienne;96430;48905;47525;114566;95092;58376;31382;395846
1997;87;Haute-Vienne;75691;38677;37014;95946;90283;59561;32943;354424
1997;88;Vosges;100866;51907;48959;103218;94977;56625;27263;382949
1997;89;Yonne;83939;43350;40589;85030;81546;52931;28251;331697
1997;90;Territoire de Belfort;36719;19063;17656;40657;34160;17800;7819;137155
1997;91;Essonne;320822;163932;156890;352878;297179;113526;47109;1131514
1997;92;Hauts-de-Seine;344140;174960;169180;469905;349638;164964;83645;1412292
1997;93;Seine-Saint-Denis;403934;205850;198084;443667;344015;140484;56704;1388804
1997;94;Val-de-Marne;314201;159918;154283;394876;309197;138739;65416;1222429
1997;95;Val-d'Oise;336031;171860;164171;337011;281395;102666;42947;1100050
1997;971;Guadeloupe;127220;64560;62660;120237;80321;33346;15040;376164
1997;972;Martinique;118107;59768;58339;116620;81756;39502;17888;373873
1997;973;Guyane;64380;32640;31740;46615;25837;5962;2143;144937
1997;974;La Réunion;261298;132564;128734;225403;131611;46241;15632;680185
1998;01;Ain;141876;72720;69156;143604;131683;61484;30873;509520
1998;02;Aisne;149465;76419;73046;146111;132305;74862;33886;536629
1998;03;Allier;74521;38184;36337;85707;89502;62214;34696;346640
1998;04;Alpes-de-Haute-Provence;33157;17111;16046;34864;36254;23166;12013;139454
1998;05;Hautes-Alpes;29966;15436;14530;32031;31117;18094;9764;120972
1998;06;Alpes-Maritimes;221683;113546;108137;259341;254532;164928;105798;1006282
1998;07;Ardèche;68374;35177;33197;72432;73624;45845;24906;285181
1998;08;Ardennes;80256;41405;38851;80051;71569;41381;18072;291329
1998;09;Ariège;29460;15232;14228;33006;34611;25042;14613;136732
1998;10;Aube;76090;38958;37132;79947;74196;40774;21669;292676
1998;11;Aude;69427;35761;33666;76102;76775;54862;30959;308125
1998;12;Aveyron;56375;29221;27154;64050;66250;49532;28212;264419
1998;13;Bouches-du-Rhône;461031;236118;224913;518834;470184;246692;127649;1824390
1998;14;Calvados;175280;88816;86464;184910;158782;84835;40706;644513
1998;15;Cantal;32052;16534;15518;38164;39254;27585;14786;151841
1998;16;Charente;79002;40559;38443;87363;87554;55494;30519;339932
1998;17;Charente-Maritime;127131;65387;61744;137066;141090;96629;50725;552641
1998;18;Cher;73516;37704;35812;81289;81440;51390;27620;315255
1998;19;Corrèze;47443;24519;22924;56871;60028;43662;25343;233347
1998;21;Côte-d'Or;130579;65960;64619;149120;126469;65075;34969;506212
1998;22;Côtes-d'Armor;130021;66764;63257;131730;135742;96505;47393;541391
1998;23;Creuse;23765;12281;11484;28580;30834;26258;15877;125314
1998;24;Dordogne;81681;42030;39651;91511;99999;74008;40851;388050
1998;25;Doubs;135391;69167;66224;146724;124760;63089;28649;498613
1998;26;Drôme;115021;59160;55861;114786;111637;62065;31747;435256
1998;27;Eure;153120;78573;74547;150479;137694;66761;31554;539608
1998;28;Eure-et-Loir;112828;57755;55073;110796;103669;53057;27862;408212
1998;29;Finistère;210474;108167;102307;229862;208220;133944;67279;849779
1998;2A;Corse-du-Sud;28002;14505;13497;30905;31228;18844;9484;118463
1998;2B;Haute-Corse;31937;16430;15507;38726;36793;22078;11469;141003
1998;30;Gard;155026;79227;75799;161129;160135;93690;48171;618151
1998;31;Haute-Garonne;249902;127339;122563;332943;254978;125416;66227;1029466
1998;32;Gers;35538;18387;17151;40734;44962;32925;18421;172580
1998;33;Gironde;312195;159145;153050;376063;325094;170322;92779;1276453
1998;34;Hérault;215973;109949;106024;253706;217425;129196;68590;884890
1998;35;Ille-et-Vilaine;230053;117185;112868;260353;203277;110939;52673;857295
1998;36;Indre;49749;25493;24256;57969;58945;41816;23773;232252
1998;37;Indre-et-Loire;138818;70121;68697;156768;137259;76237;42416;551498
1998;38;Isère;295495;151437;144058;323646;273978;131190;60894;1085203
1998;39;Jura;63941;32863;31078;66406;62898;37711;19961;250917
1998;40;Landes;72660;37664;34996;82379;83998;56927;29113;325077
1998;41;Loir-et-Cher;75578;38737;36841;80949;78452;51138;28499;314616
1998;42;Loire;187273;95670;91603;194959;185160;108609;55656;731657
1998;43;Haute-Loire;49655;25609;24046;53658;52485;34566;17921;208285
1998;44;Loire-Atlantique;305888;156051;149837;324307;280033;144886;68892;1124006
1998;45;Loiret;163608;83540;80068;173988;154764;81712;42300;616372
1998;46;Lot;33516;17237;16279;37283;40758;31177;16923;159657
1998;47;Lot-et-Garonne;69957;35918;34039;73808;78115;53667;29421;304968
1998;48;Lozère;16354;8489;7865;19015;18598;12307;7233;73507
1998;49;Maine-et-Loire;205000;104580;100420;207308;172749;95015;49479;729551
1998;50;Manche;125684;64833;60851;126269;114678;78102;36616;481349
1998;51;Marne;151832;77432;74400;171500;140379;68241;33983;565935
1998;52;Haute-Marne;50799;26283;24516;51895;49230;29647;14807;196378
1998;53;Mayenne;76082;39420;36662;76751;67354;42173;21533;283893
1998;54;Meurthe-et-Moselle;188218;96314;91904;211942;176103;96356;42443;715062
1998;55;Meuse;50591;26124;24467;51691;47427;29293;13795;192797
1998;56;Morbihan;162827;83731;79096;169061;157354;103280;47250;639772
1998;57;Moselle;271186;139067;132119;300739;259259;139158;52574;1022916
1998;58;Nièvre;50107;25754;24353;54272;58171;41532;22694;226776
1998;59;Nord;757585;386941;370644;756941;598804;308003;133609;2554942
1998;60;Oise;224165;115392;108773;223841;196445;82969;37691;765111
1998;61;Orne;75165;38762;36403;75190;72164;47323;23070;292912
1998;62;Pas-de-Calais;420076;215167;204909;402835;341816;191493;84275;1440495
1998;63;Puy-de-Dôme;141210;71808;69402;171074;160264;87410;42895;602853
1998;64;Pyrénées-Atlantiques;137369;70731;66638;158090;150875;95986;51925;594245
1998;65;Hautes-Pyrénées;47714;24600;23114;55916;58707;39127;21300;222764
1998;66;Pyrénées-Orientales;88433;45243;43190;96770;94334;70944;38570;389051
1998;67;Bas-Rhin;263295;134189;129106;318861;253183;125447;55805;1016591
1998;68;Haut-Rhin;185021;94730;90291;206582;180756;92441;38594;703394
1998;69;Rhône;418163;212135;206028;481055;383384;190458;93155;1566215
1998;70;Haute-Saône;59554;30764;28790;60421;58744;33448;16983;229150
1998;71;Saône-et-Loire;130454;67244;63210;138385;141258;89773;47602;547472
1998;72;Sarthe;136431;69784;66647;145162;128980;76720;40394;527687
1998;73;Savoie;94527;48642;45885;106491;94865;49769;24245;369897
1998;74;Haute-Savoie;169444;87433;82011;187078;164524;71560;33248;625854
1998;75;Paris;407304;204644;202660;765258;536524;246059;156170;2111315
1998;76;Seine-Maritime;343207;175189;168018;356839;306105;156493;77140;1239784
1998;77;Seine-et-Marne;355680;182197;173483;353291;310238;110254;53080;1182543
1998;78;Yvelines;391616;200703;190913;398616;365116;138329;60046;1353723
1998;79;Deux-Sèvres;83835;43358;40477;90196;86197;54983;29363;344574
1998;80;Somme;149161;75880;73281;161403;134197;74101;35733;554595
1998;81;Tarn;78193;40332;37861;83934;86962;60577;32963;342629
1998;82;Tarn-et-Garonne;48527;24931;23596;52304;52163;33847;18678;205519
1998;83;Var;211504;108345;103159;224309;227039;150819;77927;891598
1998;84;Vaucluse;130393;66806;63587;132754;127173;70931;35697;496948
1998;85;Vendée;135639;69692;65947;140330;130822;87082;41449;535322
1998;86;Vienne;96394;48826;47568;114271;96850;58024;32402;397941
1998;87;Haute-Vienne;75112;38352;36760;95119;91280;58554;33876;353941
1998;88;Vosges;99780;51303;48477;101642;95834;56519;28016;381791
1998;89;Yonne;83533;43087;40446;84370;83355;52440;29075;332773
1998;90;Territoire de Belfort;36432;18881;17551;40314;34643;17655;8190;137234
1998;91;Essonne;320668;163788;156880;349237;299925;115130;48693;1133653
1998;92;Hauts-de-Seine;346798;176318;170480;469396;353524;163417;85975;1419110
1998;93;Seine-Saint-Denis;402490;205085;197405;437812;347532;139888;58301;1386023
1998;94;Val-de-Marne;315071;160388;154683;391721;312974;137993;67714;1225473
1998;95;Val-d'Oise;334550;171021;163529;333218;285747;102990;44277;1100782
1998;971;Guadeloupe;126692;64310;62382;121010;83131;34172;15733;380738
1998;972;Martinique;117345;59335;58010;116858;84003;40449;18566;377221
1998;973;Guyane;66762;33850;32912;47755;27292;6178;2255;150242
1998;974;La Réunion;263183;133629;129554;228359;136181;47942;16519;692184
1999;01;Ain;142732;73202;69530;143334;134761;61727;31777;514331
1999;02;Aisne;148660;76101;72559;143757;134542;73929;35293;536181
1999;03;Allier;73728;37835;35893;84220;90173;61283;35668;345072
1999;04;Alpes-de-Haute-Provence;33148;17130;16018;34127;36710;23120;12410;139515
1999;05;Hautes-Alpes;29865;15342;14523;31669;31668;18072;10064;121338
1999;06;Alpes-Maritimes;222865;114270;108595;258647;258299;163391;107442;1010644
1999;07;Ardèche;68296;35256;33040;71736;74762;45575;25520;285889
1999;08;Ardennes;79480;40964;38516;78902;72306;41119;18645;290452
1999;09;Ariège;29578;15339;14239;32606;35359;24666;14992;137201
1999;10;Aube;75573;38660;36913;78913;75075;40522;22234;292317
1999;11;Aude;69661;35814;33847;75342;78595;54167;31698;309463
1999;12;Aveyron;55967;29059;26908;63208;67080;48832;28961;264048
1999;13;Bouches-du-Rhône;462439;236699;225740;516980;477183;245917;131463;1833982
1999;14;Calvados;175042;88607;86435;183814;161938;84668;42489;647951
1999;15;Cantal;31497;16263;15234;37352;39539;27296;15293;150977
1999;16;Charente;78726;40515;38211;85772;89152;54775;31403;339828
1999;17;Charente-Maritime;127174;65521;61653;136146;144028;95910;53161;556419
1999;18;Cher;73165;37565;35600;79636;82583;50907;28312;314603
1999;19;Corrèze;47082;24337;22745;55952;60703;42913;26169;232819
1999;21;Côte-d'Or;130027;65576;64451;147444;128420;64789;36019;506699
1999;22;Côtes-d'Armor;129467;66565;62902;130074;137736;95498;49623;542398
1999;23;Creuse;23587;12168;11419;27961;31327;25539;16183;124597
1999;24;Dordogne;81310;41850;39460;90179;101762;73004;42152;388407
1999;25;Doubs;134698;68802;65896;145228;126123;63367;29807;499223
1999;26;Drôme;115260;59353;55907;113907;113645;62039;32803;437654
1999;27;Eure;152484;78318;74166;148647;140546;66681;32560;540918
1999;28;Eure-et-Loir;111610;57134;54476;109491;105332;52735;28539;407707
1999;29;Finistère;210108;107990;102118;227685;211804;132683;69993;852273
1999;2A;Corse-du-Sud;27842;14450;13392;30341;31731;18782;9770;118466
1999;2B;Haute-Corse;32042;16530;15512;38492;37297;22052;11803;141686
1999;30;Gard;155906;79696;76210;160060;163582;93332;49629;622509
1999;31;Haute-Garonne;254103;129288;124815;334626;261775;125314;68390;1044208
1999;32;Gers;35541;18367;17174;39924;45597;32573;18849;172484
1999;33;Gironde;313783;160025;153758;374758;332241;169395;95895;1286072
1999;34;Hérault;217996;111121;106875;254458;222396;128659;71028;894537
1999;35;Ille-et-Vilaine;231285;117773;113512;260718;207846;111018;55244;866111
1999;36;Indre;49336;25254;24082;56953;59436;41346;24294;231365
1999;37;Indre-et-Loire;138850;70086;68764;155643;139596;75915;43686;553690
1999;38;Isère;296337;151849;144488;323280;278362;131787;63012;1092778
1999;39;Jura;63595;32752;30843;65597;63725;37379;20609;250905
1999;40;Landes;72865;37799;35066;81860;85676;56647;30192;327240
1999;41;Loir-et-Cher;75283;38529;36754;80019;79498;50932;29263;314995
1999;42;Loire;185439;94722;90717;192205;186290;107661;57486;729081
1999;43;Haute-Loire;49605;25664;23941;53343;53404;34293;18441;209086
1999;44;Loire-Atlantique;306003;156177;149826;324446;285900;144611;72287;1133247
1999;45;Loiret;163382;83531;79851;172310;157226;81356;43661;617935
1999;46;Lot;33567;17283;16284;36837;41460;30821;17545;160230
1999;47;Lot-et-Garonne;69748;35795;33953;72885;79384;53004;30461;305482
1999;48;Lozère;16235;8426;7809;18863;18881;12141;7393;73513
1999;49;Maine-et-Loire;204002;103840;100162;206400;175982;94482;51758;732624
1999;50;Manche;124814;64279;60535;124124;116789;77462;38277;481466
1999;51;Marne;150620;76948;73672;169577;142134;68092;34943;565366
1999;52;Haute-Marne;49937;25842;24095;50787;49658;29407;15342;195131
1999;53;Mayenne;75918;39281;36637;76402;68444;41907;22547;285218
1999;54;Meurthe-et-Moselle;187141;95806;91335;209445;177776;95848;44085;714295
1999;55;Meuse;50145;25914;24231;50924;48086;29024;14264;192443
1999;56;Morbihan;162117;83448;78669;167077;161235;103208;49656;643293
1999;57;Moselle;269423;138198;131225;296674;263012;139781;54873;1023763
1999;58;Nièvre;49452;25473;23979;53248;58616;41013;23156;225485
1999;59;Nord;753688;385004;368684;751576;606955;304859;138393;2555471
1999;60;Oise;223006;114864;108142;221843;199618;82996;38790;766253
1999;61;Orne;74606;38516;36090;73970;73094;46888;23972;292530
1999;62;Pas-de-Calais;417664;214152;203512;398813;348188;189581;87750;1441996
1999;63;Puy-de-Dôme;140724;71582;69142;169644;162582;86847;44442;604239
1999;64;Pyrénées-Atlantiques;138016;71078;66938;157505;154367;96143;53516;599547
1999;65;Hautes-Pyrénées;47617;24561;23056;54992;59484;38751;21787;222631
1999;66;Pyrénées-Orientales;89212;45621;43591;96540;96336;70472;39823;392383
1999;67;Bas-Rhin;264903;134964;129939;317319;258911;126308;57592;1025033
1999;68;Haut-Rhin;185532;94932;90600;204766;184272;92930;40055;707555
1999;69;Rhône;420435;213259;207176;480779;389092;190702;96087;1577095
1999;70;Haute-Saône;59314;30665;28649;59896;59704;33343;17471;229728
1999;71;Saône-et-Loire;129092;66596;62496;135709;142573;88876;49193;545443
1999;72;Sarthe;136344;69707;66637;143879;131143;76437;41979;529782
1999;73;Savoie;94928;48923;46005;105931;96881;49792;25220;372752
1999;74;Haute-Savoie;170153;87820;82333;185849;168166;71975;34511;630654
1999;75;Paris;410023;206090;203933;768749;544064;244350;156500;2123686
1999;76;Seine-Maritime;341566;174336;167230;352277;310570;155773;79398;1239584
1999;77;Seine-et-Marne;356741;182688;174053;352826;316426;111416;54366;1191775
1999;78;Yvelines;389493;199675;189818;394973;367561;139960;61958;1353945
1999;79;Deux-Sèvres;83215;43083;40132;88904;87507;54512;30348;344486
1999;80;Somme;148672;75645;73027;159969;136447;73346;37113;555547
1999;81;Tarn;78089;40257;37832;83032;88375;59872;34076;343444
1999;82;Tarn-et-Garonne;48559;24981;23578;51768;53021;33410;19271;206029
1999;83;Var;212188;108757;103431;222578;231596;150582;80641;897585
1999;84;Vaucluse;130689;67096;63593;131956;129228;70497;36951;499321
1999;85;Vendée;134793;69244;65549;139768;133870;86921;43737;539089
1999;86;Vienne;96279;48669;47610;113748;98283;57266;33426;399002
1999;87;Haute-Vienne;74935;38186;36749;94413;92298;57747;34662;354055
1999;88;Vosges;98875;50927;47948;100138;97026;56285;28830;381154
1999;89;Yonne;83212;42873;40339;83485;84703;52003;29803;333206
1999;90;Territoire de Belfort;36351;18829;17522;39838;35162;17572;8474;137397
1999;91;Essonne;320278;163654;156624;344560;302227;116714;50057;1133836
1999;92;Hauts-de-Seine;350111;178037;172074;469194;358530;162130;87923;1427888
1999;93;Seine-Saint-Denis;402436;205001;197435;431195;351039;139284;59365;1383319
1999;94;Val-de-Marne;316261;160949;155312;387606;316252;137272;69639;1227030
1999;95;Val-d'Oise;334367;170895;163472;330363;290677;103461;45665;1104533
1999;971;Guadeloupe;126024;64003;62021;120063;85774;36494;17254;385609
1999;972;Martinique;116634;58924;57710;117212;86321;41423;19273;380863
1999;973;Guyane;69234;35112;34122;48923;28834;6400;2369;155760
1999;974;La Réunion;265370;134963;130407;230999;140720;49229;17502;703820
2000;01;Ain;144423;73966;70457;143269;138484;62161;32766;521103
2000;02;Aisne;148412;75796;72616;141149;137021;72933;36745;536260
2000;03;Allier;73522;37708;35814;82572;91361;60546;36709;344710
2000;04;Alpes-de-Haute-Provence;33705;17348;16357;33705;37858;23394;12792;141454
2000;05;Hautes-Alpes;30169;15475;14694;31213;32647;18047;10466;122542
2000;06;Alpes-Maritimes;224566;115242;109324;258122;262843;163374;109051;1017956
2000;07;Ardèche;68840;35473;33367;71065;76478;45618;26385;288386
2000;08;Ardennes;78878;40568;38310;77292;73480;40718;19241;289609
2000;09;Ariège;29938;15514;14424;32235;36386;24381;15259;138199
2000;10;Aube;75523;38533;36990;78075;76241;40499;22847;293185
2000;11;Aude;70777;36251;34526;75355;80842;53961;32406;313341
2000;12;Aveyron;56200;29075;27125;62453;68187;48525;29700;265065
2000;13;Bouches-du-Rhône;464043;237571;226472;515726;485691;246121;135297;1846878
2000;14;Calvados;173939;88103;85836;182660;165492;84902;44200;651193
2000;15;Cantal;31216;16031;15185;36568;40104;27048;15704;150640
2000;16;Charente;78641;40388;38253;84427;90896;54653;32144;340761
2000;17;Charente-Maritime;127938;65755;62183;135480;147385;96073;54866;561742
2000;18;Cher;73405;37640;35765;77927;83725;50667;28860;314584
2000;19;Corrèze;47264;24400;22864;55225;61620;42576;26946;233631
2000;21;Côte-d'Or;128845;65167;63678;146583;130900;64878;36809;508015
2000;22;Côtes-d'Armor;129699;66457;63242;129118;140446;95167;51226;545656
2000;23;Creuse;23630;12179;11451;27283;31851;25115;16424;124303
2000;24;Dordogne;81706;41986;39720;88737;103890;72608;43331;390272
2000;25;Doubs;133902;68437;65465;144888;128180;63737;30716;501423
2000;26;Drôme;115762;59562;56200;113222;116180;62394;33922;441480
2000;27;Eure;153239;78518;74721;146951;143885;66899;33661;544635
2000;28;Eure-et-Loir;111672;57065;54607;108262;107426;52592;29390;409342
2000;29;Finistère;210056;107858;102198;225276;215732;132474;72386;855924
2000;2A;Corse-du-Sud;28196;14663;13533;30475;32779;19170;10133;120753
2000;2B;Haute-Corse;32290;16646;15644;38628;38341;22333;12194;143786
2000;30;Gard;157438;80455;76983;159729;168233;93553;51098;630051
2000;31;Haute-Garonne;256885;130770;126115;339757;269714;125826;70332;1062514
2000;32;Gers;35909;18459;17450;39274;46532;32369;19438;173522
2000;33;Gironde;314898;160553;154345;376182;340762;169074;98861;1299777
2000;34;Hérault;220086;112353;107733;256162;228899;129337;73263;907747
2000;35;Ille-et-Vilaine;232093;118312;113781;262614;212705;111092;57697;876201
2000;36;Indre;49394;25261;24133;55804;60351;41153;24739;231441
2000;37;Indre-et-Loire;138677;70230;68447;154770;142720;76091;44912;557170
2000;38;Isère;297166;152371;144795;323383;284378;132624;64780;1102331
2000;39;Jura;63867;32896;30971;64619;64898;37226;21201;251811
2000;40;Landes;74116;38387;35729;81376;88045;56845;31128;331510
2000;41;Loir-et-Cher;75451;38578;36873;78906;81121;50721;30155;316354
2000;42;Loire;184596;94392;90204;190618;188550;107670;59180;730614
2000;43;Haute-Loire;50078;25843;24235;52563;54491;34291;18987;210410
2000;44;Loire-Atlantique;306669;156502;150167;325923;292964;145348;75154;1146058
2000;45;Loiret;163272;83462;79810;171419;160237;81176;45126;621230
2000;46;Lot;33840;17432;16408;36287;42487;30727;18034;161375
2000;47;Lot-et-Garonne;70073;35920;34153;72252;81014;52777;31299;307415
2000;48;Lozère;16300;8446;7854;18690;19257;12112;7492;73851
2000;49;Maine-et-Loire;202851;103195;99656;205890;180221;94353;53552;736867
2000;50;Manche;124561;63841;60720;121945;119421;77172;40079;483178
2000;51;Marne;149182;76289;72893;167550;144493;67981;35983;565189
2000;52;Haute-Marne;49395;25524;23871;49423;50168;29243;15795;194024
2000;53;Mayenne;76077;39238;36839;75741;70130;41675;23347;286970
2000;54;Meurthe-et-Moselle;185603;95075;90528;208368;180435;95639;45639;715684
2000;55;Meuse;50179;25931;24248;50071;49067;28636;14729;192682
2000;56;Morbihan;162703;83829;78874;166115;165595;103703;51715;649831
2000;57;Moselle;267655;137148;130507;292446;267881;140317;57217;1025516
2000;58;Nièvre;49216;25308;23908;51822;59413;40786;23817;225054
2000;59;Nord;747351;381834;365517;745004;616434;301978;143871;2554638
2000;60;Oise;223557;114977;108580;219321;203701;83491;39778;769848
2000;61;Orne;74187;38228;35959;72475;74471;46455;24969;292557
2000;62;Pas-de-Calais;415294;212739;202555;393978;355237;187341;91376;1443226
2000;63;Puy-de-Dôme;139913;71244;68669;168884;164977;86793;45900;606467
2000;64;Pyrénées-Atlantiques;138553;71305;67248;156437;157877;96229;55153;604249
2000;65;Hautes-Pyrénées;47647;24544;23103;53981;60597;38637;22437;223299
2000;66;Pyrénées-Orientales;90240;46044;44196;96550;99199;70380;40713;397082
2000;67;Bas-Rhin;265267;135138;130129;316086;264844;127223;59078;1032498
2000;68;Haut-Rhin;186119;95183;90936;202691;188126;93242;41279;711457
2000;69;Rhône;420759;213632;207127;482320;395392;191399;99040;1588910
2000;70;Haute-Saône;59225;30570;28655;59159;60835;33364;17797;230380
2000;71;Saône-et-Loire;128651;66202;62449;133469;144422;88555;50626;545723
2000;72;Sarthe;136694;69897;66797;142742;133849;76305;43175;532765
2000;73;Savoie;95386;49258;46128;105635;99437;50118;25940;376516
2000;74;Haute-Savoie;171838;88587;83251;186156;172727;72777;35686;639184
2000;75;Paris;410964;206804;204160;771095;548164;242061;157447;2129731
2000;76;Seine-Maritime;339398;173141;166257;347129;315903;155613;81897;1239940
2000;77;Seine-et-Marne;358435;183356;175079;351983;323961;112556;55634;1202569
2000;78;Yvelines;389275;199382;189893;391680;372130;141923;63808;1358816
2000;79;Deux-Sèvres;83699;43273;40426;87710;89468;54179;31376;346432
2000;80;Somme;147969;75342;72627;158583;138967;72875;38436;556830
2000;81;Tarn;78292;40298;37994;82550;90349;59596;35072;345859
2000;82;Tarn-et-Garonne;49299;25318;23981;51740;54422;33253;19707;208421
2000;83;Var;214744;109932;104812;221526;237724;151598;83303;908895
2000;84;Vaucluse;131489;67458;64031;131281;132151;70929;37933;503783
2000;85;Vendée;135463;69425;66038;139660;138141;87501;45569;546334
2000;86;Vienne;95772;48588;47184;113678;100410;57213;34370;401443
2000;87;Haute-Vienne;74621;38163;36458;94010;93915;57254;35515;355315
2000;88;Vosges;98601;50748;47853;98151;98373;56274;29628;381027
2000;89;Yonne;83262;42773;40489;82166;86414;51606;30578;334026
2000;90;Territoire de Belfort;36244;18748;17496;39495;35827;17652;8680;137898
2000;91;Essonne;322366;164536;157830;342737;306774;118991;51463;1142331
2000;92;Hauts-de-Seine;354340;180273;174067;471518;364892;160956;90381;1442087
2000;93;Seine-Saint-Denis;406542;206947;199595;432871;357260;139219;61050;1396942
2000;94;Val-de-Marne;319170;162602;156568;386819;321812;137034;71608;1236443
2000;95;Val-d'Oise;334840;171101;163739;328494;296499;104032;47207;1111072
2000;971;Guadeloupe;126197;63969;62228;117534;88926;37307;18081;388045
2000;972;Martinique;116810;59022;57788;114742;89953;41956;20114;383575
2000;973;Guyane;72442;36694;35748;49994;30420;6630;2532;162018
2000;974;La Réunion;267099;135762;131337;232747;147294;50588;18586;716314
2001;01;Ain;145856;74649;71207;144025;142275;62270;33769;528195
2001;02;Aisne;147477;75152;72325;139639;139882;71521;38107;536626
2001;03;Allier;73360;37575;35785;81293;92804;59461;37633;344551
2001;04;Alpes-de-Haute-Provence;34136;17559;16577;33588;39043;23526;13281;143574
2001;05;Hautes-Alpes;30379;15587;14792;30909;33639;18124;10822;123873
2001;06;Alpes-Maritimes;226407;116208;110199;258351;267308;163079;111310;1026455
2001;07;Ardèche;69324;35751;33573;70794;78373;45423;27165;291079
2001;08;Ardennes;78106;40112;37994;76017;74817;40225;19876;289041
2001;09;Ariège;30302;15661;14641;31967;37566;24037;15516;139388
2001;10;Aube;75253;38336;36917;77517;77819;40303;23418;294310
2001;11;Aude;71769;36686;35083;75452;83536;53469;33323;317549
2001;12;Aveyron;56361;29092;27269;61914;69853;47789;30452;266369
2001;13;Bouches-du-Rhône;465133;238133;227000;515917;493981;246375;139542;1860948
2001;14;Calvados;172786;87543;85243;182289;169180;84556;45873;654684
2001;15;Cantal;30922;15840;15082;35960;40845;26529;16201;150457
2001;16;Charente;78285;40151;38134;83560;92963;54031;33120;341959
2001;17;Charente-Maritime;128498;65962;62536;135443;151269;95764;56643;567617
2001;18;Cher;73279;37493;35786;76698;85071;50190;29398;314636
2001;19;Corrèze;47446;24514;22932;54654;63102;41820;27545;234567
2001;21;Côte-d'Or;127572;64662;62910;146223;133417;64646;37856;509714
2001;22;Côtes-d'Armor;130012;66554;63458;128656;143574;94201;53060;549503
2001;23;Creuse;23708;12205;11503;26628;32563;24404;16792;124095
2001;24;Dordogne;82106;42103;40003;87768;106271;71651;44697;392493
2001;25;Doubs;133269;68169;65100;144708;130352;63941;31659;503929
2001;26;Drôme;116242;59772;56470;113195;118961;62412;35052;445862
2001;27;Eure;153229;78366;74863;146282;147482;66657;34852;548502
2001;28;Eure-et-Loir;111420;56897;54523;107729;109499;52223;30421;411292
2001;29;Finistère;209909;107716;102193;223662;220946;131258;74765;860540
2001;2A;Corse-du-Sud;28471;14799;13672;30675;33796;19746;10497;123185
2001;2B;Haute-Corse;32634;16790;15844;38789;39354;22757;12554;146088
2001;30;Gard;158919;81113;77806;159877;173188;93514;52668;638166
2001;31;Haute-Garonne;260282;132834;127448;345252;278458;125670;72478;1082140
2001;32;Gers;36285;18610;17675;38682;47774;31992;19948;174681
2001;33;Gironde;316191;161105;155086;378587;350176;167738;101975;1314667
2001;34;Hérault;222026;113435;108591;258276;235720;129788;75711;921521
2001;35;Ille-et-Vilaine;233329;119278;114051;265003;218779;110337;59975;887423
2001;36;Indre;49430;25214;24216;54961;61532;40500;25258;231681
2001;37;Indre-et-Loire;138593;70490;68103;154513;145926;75887;46232;561151
2001;38;Isère;298546;153378;145168;324137;290415;132868;67051;1113017
2001;39;Jura;63918;32915;31003;63872;66297;36812;21941;252840
2001;40;Landes;75284;38921;36363;81346;91056;56508;32276;336470
2001;41;Loir-et-Cher;75536;38534;37002;78012;83051;50228;30956;317783
2001;42;Loire;183908;94003;89905;189529;191323;106597;61171;732528
2001;43;Haute-Loire;50463;26012;24451;52125;55816;33932;19438;211774
2001;44;Loire-Atlantique;308080;157250;150830;328313;300876;144746;78224;1160239
2001;45;Loiret;163648;83748;79900;170520;163557;80700;46810;625235
2001;46;Lot;34039;17512;16527;35997;43690;30270;18684;162680
2001;47;Lot-et-Garonne;70167;35959;34208;71986;82905;52483;32138;309679
2001;48;Lozère;16478;8558;7920;18524;19732;11913;7701;74348
2001;49;Maine-et-Loire;202170;102951;99219;206295;184587;93653;55367;742072
2001;50;Manche;123967;63525;60442;120339;122604;76205;41733;484848
2001;51;Marne;147802;75652;72150;166002;147122;67369;37240;565535
2001;52;Haute-Marne;48768;25185;23583;48295;50907;28884;16138;192992
2001;53;Mayenne;76381;39351;37030;75340;72058;41165;24180;289124
2001;54;Meurthe-et-Moselle;184263;94463;89800;207683;183313;94662;47437;717358
2001;55;Meuse;50178;25912;24266;49430;50135;28067;15209;193019
2001;56;Morbihan;163103;84122;78981;165911;170649;103305;53890;656858
2001;57;Moselle;265309;135851;129458;289619;273409;139559;59562;1027458
2001;58;Nièvre;48768;24969;23799;50696;60326;40302;24477;224569
2001;59;Nord;740797;378719;362078;741239;627028;297280;149615;2555959
2001;60;Oise;223259;114625;108634;218084;207881;83297;41192;773713
2001;61;Orne;73755;37952;35803;71328;76017;45878;25890;292868
2001;62;Pas-de-Calais;412559;211155;201404;390763;362873;183981;95007;1445183
2001;63;Puy-de-Dôme;139095;71124;67971;168694;167860;86016;47497;609162
2001;64;Pyrénées-Atlantiques;138979;71517;67462;155980;161866;95863;56917;609605
2001;65;Hautes-Pyrénées;47611;24519;23092;53171;61923;38184;23041;223930
2001;66;Pyrénées-Orientales;90845;46337;44508;97073;102119;70078;41930;402045
2001;67;Bas-Rhin;265680;135344;130336;315391;271638;126913;60899;1040521
2001;68;Haut-Rhin;186036;95044;90992;201515;192145;93247;42614;715557
2001;69;Rhône;420939;213941;206998;485195;401872;191656;102310;1601972
2001;70;Haute-Saône;59066;30485;28581;58698;62233;33100;18316;231413
2001;71;Saône-et-Loire;128168;65904;62264;131573;146979;87436;52156;546312
2001;72;Sarthe;137263;70089;67174;141804;137007;75486;44596;536156
2001;73;Savoie;96022;49778;46244;105714;101919;50252;26824;380731
2001;74;Haute-Savoie;173721;89553;84168;186989;177017;73653;37113;648493
2001;75;Paris;411657;207625;204032;774605;552188;240084;158908;2137442
2001;76;Seine-Maritime;336986;171800;165186;343643;321149;154583;84543;1240904
2001;77;Seine-et-Marne;359829;183877;175952;352634;331421;113387;57023;1214294
2001;78;Yvelines;388894;199040;189854;389731;377164;143438;65788;1365015
2001;79;Deux-Sèvres;83901;43288;40613;87096;91779;53445;32378;348599
2001;80;Somme;147094;75028;72066;157775;141900;71813;39838;558420
2001;81;Tarn;78842;40571;38271;82305;92824;58626;36303;348900
2001;82;Tarn-et-Garonne;50065;25701;24364;51904;56046;32964;20155;211134
2001;83;Var;216385;110693;105692;221849;243463;152714;86621;921032
2001;84;Vaucluse;131766;67660;64106;131191;135148;71155;39237;508497
2001;85;Vendée;136217;69692;66525;140208;142628;87673;47362;554088
2001;86;Vienne;95195;48348;46847;113794;102900;56812;35257;403958
2001;87;Haute-Vienne;74657;38271;36386;93648;96019;56208;36602;357134
2001;88;Vosges;97878;50286;47592;96745;100267;55765;30301;380956
2001;89;Yonne;83008;42510;40498;81422;88207;50932;31487;335056
2001;90;Territoire de Belfort;36045;18601;17444;39475;36399;17599;8995;138513
2001;91;Essonne;324221;165446;158775;341390;312201;120352;53357;1151521
2001;92;Hauts-de-Seine;359269;182630;176639;474273;371312;159631;93253;1457738
2001;93;Seine-Saint-Denis;410396;208809;201587;435551;363762;139063;63017;1411789
2001;94;Val-de-Marne;322024;163902;158122;386754;327596;136773;73577;1246724
2001;95;Val-d'Oise;335087;171117;163970;327873;302169;104362;48810;1118301
2001;971;Guadeloupe;125970;63955;62015;115200;92549;37970;18983;390672
2001;972;Martinique;117064;59076;57988;112332;93700;42675;20771;386542
2001;973;Guyane;75723;38374;37349;51236;32058;6887;2710;168614
2001;974;La Réunion;269609;137168;132441;233311;153858;52585;19647;729010
2002;01;Ain;146640;75084;71556;145248;146194;62718;34816;535616
2002;02;Aisne;145835;74255;71580;138617;143369;69349;39614;536784
2002;03;Allier;72876;37362;35514;80217;94450;58224;38588;344355
2002;04;Alpes-de-Haute-Provence;34434;17741;16693;33536;40312;23687;13781;145750
2002;05;Hautes-Alpes;30512;15675;14837;30821;34593;18193;11168;125287
2002;06;Alpes-Maritimes;228456;117146;111310;258535;271996;163015;113269;1035271
2002;07;Ardèche;69532;35796;33736;70727;80333;45377;27953;293922
2002;08;Ardennes;76907;39486;37421;75282;76507;39230;20594;288520
2002;09;Ariège;30437;15756;14681;31910;38731;23662;15941;140681
2002;10;Aube;74831;38150;36681;77082;79478;39798;24230;295419
2002;11;Aude;72474;37044;35430;75956;86233;53232;34077;321972
2002;12;Aveyron;56147;29026;27121;61762;71448;47178;31231;267766
2002;13;Bouches-du-Rhône;468318;239841;228477;514714;502316;246704;144258;1876310
2002;14;Calvados;172549;87206;85343;180520;173396;84001;47723;658189
2002;15;Cantal;30462;15625;14837;35497;41727;25922;16573;150181
2002;16;Charente;77747;39865;37882;82942;94904;53465;33954;343012
2002;17;Charente-Maritime;128884;66176;62708;135663;155569;95081;58620;573817
2002;18;Cher;72858;37278;35580;75714;86767;49498;30050;314887
2002;19;Corrèze;47382;24588;22794;54390;64536;41146;28321;235775
2002;21;Côte-d'Or;127683;64684;62999;144366;136277;64014;38857;511197
2002;22;Côtes-d'Armor;129699;66561;63138;128691;147567;92596;55003;553556
2002;23;Creuse;23559;12139;11420;26276;33345;23684;17089;123953
2002;24;Dordogne;81905;41923;39982;87190;109029;70740;45883;394747
2002;25;Doubs;132757;67900;64857;144212;133078;63404;32790;506241
2002;26;Drôme;116353;59889;56464;113382;121595;62807;36077;450214
2002;27;Eure;152816;78089;74727;146123;151118;66165;35989;552211
2002;28;Eure-et-Loir;110670;56524;54146;107738;111688;51635;31394;413125
2002;29;Finistère;209649;107514;102135;222327;227343;128604;77083;865006
2002;2A;Corse-du-Sud;28464;14803;13661;31155;34891;20156;10996;125662
2002;2B;Haute-Corse;32780;16864;15916;39079;40640;22900;13032;148431
2002;30;Gard;160426;81838;78588;160410;177998;93627;54515;646976
2002;31;Haute-Garonne;266946;136081;130865;347598;287191;126138;74541;1102414
2002;32;Gers;36445;18693;17752;38413;49119;31553;20519;176049
2002;33;Gironde;319508;162565;156943;379542;359538;166651;104856;1330095
2002;34;Hérault;226354;115533;110821;259290;242606;130406;78331;936987
2002;35;Ille-et-Vilaine;236272;120570;115702;265985;225454;109295;61903;898909
2002;36;Indre;49181;25048;24133;54387;62687;39825;25786;231866
2002;37;Indre-et-Loire;139333;70874;68459;153323;149281;75409;47540;564886
2002;38;Isère;300995;154715;146280;324375;295951;133497;69367;1124185
2002;39;Jura;63541;32722;30819;63421;67822;36416;22675;253875
2002;40;Landes;75924;39269;36655;81692;94205;56219;33416;341456
2002;41;Loir-et-Cher;75144;38353;36791;77785;84896;49499;31820;319144
2002;42;Loire;182980;93704;89276;188666;194092;105464;63065;734267
2002;43;Haute-Loire;50324;25997;24327;52105;57257;33534;20026;213246
2002;44;Loire-Atlantique;310188;158387;151801;329687;309733;143753;81131;1174492
2002;45;Loiret;163640;83803;79837;170266;167014;79841;48309;629070
2002;46;Lot;34103;17521;16582;35791;44984;29983;19215;164076
2002;47;Lot-et-Garonne;69970;35856;34114;72072;84620;52114;33208;311984
2002;48;Lozère;16428;8567;7861;18511;20253;11757;7908;74857
2002;49;Maine-et-Loire;201883;102746;99137;205851;189624;92508;57223;747089
2002;50;Manche;122696;62670;60026;119359;126204;74870;43415;486544
2002;51;Marne;146962;75238;71724;164089;150085;66237;38409;565782
2002;52;Haute-Marne;47595;24553;23042;47545;51895;28265;16614;191914
2002;53;Mayenne;76179;39253;36926;75308;74162;40609;24868;291126
2002;54;Meurthe-et-Moselle;183943;94177;89766;205699;187698;92708;49151;719199
2002;55;Meuse;49654;25705;23949;49235;51489;27235;15699;193312
2002;56;Morbihan;163052;84256;78796;166365;176666;102231;55980;664294
2002;57;Moselle;262144;134250;127894;287268;279555;138358;62311;1029636
2002;58;Nièvre;48033;24610;23423;49910;61467;39572;25157;224139
2002;59;Nord;734623;375740;358883;737249;643109;288037;155195;2558213
2002;60;Oise;222118;114157;107961;217793;212607;82583;42511;777612
2002;61;Orne;72837;37476;35361;70715;77555;45158;26803;293068
2002;62;Pas-de-Calais;408584;209194;199390;388861;373530;177682;98707;1447364
2002;63;Puy-de-Dôme;139383;71208;68175;167395;170970;85107;49163;612018
2002;64;Pyrénées-Atlantiques;138979;71516;67463;155907;166058;95318;58588;614850
2002;65;Hautes-Pyrénées;47576;24543;23033;52405;63088;37957;23631;224657
2002;66;Pyrénées-Orientales;92119;46964;45155;97595;105272;69755;43190;407931
2002;67;Bas-Rhin;266593;135770;130823;313814;277534;127586;62778;1048305
2002;68;Haut-Rhin;185594;94822;90772;200585;196012;93215;44343;719749
2002;69;Rhône;423434;215026;208408;485671;408345;191631;106035;1615116
2002;70;Haute-Saône;58614;30314;28300;58538;63764;32562;18827;232305
2002;71;Saône-et-Loire;126902;65421;61481;130459;149862;86127;53788;547138
2002;72;Sarthe;137588;70352;67236;141224;140292;74689;45927;539720
2002;73;Savoie;96723;50160;46563;105612;104622;50282;27860;385099
2002;74;Haute-Savoie;174620;90140;84480;188356;181605;74820;38324;657725
2002;75;Paris;416549;209955;206594;774937;556427;237629;159930;2145472
2002;76;Seine-Maritime;334601;170441;164160;340057;327578;152363;87289;1241888
2002;77;Seine-et-Marne;360434;184002;176432;354155;338990;113866;58335;1225780
2002;78;Yvelines;387996;198880;189116;388551;382279;144083;68198;1371107
2002;79;Deux-Sèvres;83445;43067;40378;87198;94067;52559;33530;350799
2002;80;Somme;146707;74855;71852;156451;145361;70210;41191;559920
2002;81;Tarn;79074;40651;38423;82264;95179;57948;37657;352122
2002;82;Tarn-et-Garonne;50690;25984;24706;52305;57724;32752;20744;214215
2002;83;Var;217737;111478;106259;222638;249885;153585;89757;933602
2002;84;Vaucluse;132062;67839;64223;131200;138095;71340;40579;513276
2002;85;Vendée;136390;69896;66494;141332;147803;87432;49265;562222
2002;86;Vienne;96100;48711;47389;112717;105567;56328;36120;406832
2002;87;Haute-Vienne;75122;38482;36640;93020;98080;55316;37450;358988
2002;88;Vosges;96466;49609;46857;95819;103036;54334;31224;380879
2002;89;Yonne;82262;42097;40165;81124;90277;49969;32331;335963
2002;90;Territoire de Belfort;35896;18544;17352;39290;37105;17333;9410;139034
2002;91;Essonne;326113;166329;159784;340575;317794;120858;55325;1160665
2002;92;Hauts-de-Seine;364496;185236;179260;476636;377918;158274;95756;1473080
2002;93;Seine-Saint-Denis;414427;210764;203663;439638;369923;138165;65051;1427204
2002;94;Val-de-Marne;324496;165089;159407;387075;333774;135598;75572;1256515
2002;95;Val-d'Oise;335267;171121;164146;327875;307772;104379;50447;1125740
2002;971;Guadeloupe;125611;64003;61608;113075;95994;38679;19665;393024
2002;972;Martinique;117015;58936;58079;109998;97552;43404;21333;389302
2002;973;Guyane;79348;40175;39173;53199;34062;7143;2886;176638
2002;974;La Réunion;271555;138131;133424;232868;161116;54021;20647;740207
2003;01;Ain;147793;75695;72098;146212;149722;63598;35811;543136
2003;02;Aisne;144481;73538;70943;137507;145834;68038;40791;536651
2003;03;Allier;72268;37123;35145;79277;95675;57415;39370;344005
2003;04;Alpes-de-Haute-Provence;34680;17805;16875;33509;41594;23913;14274;147970
2003;05;Hautes-Alpes;30599;15719;14880;30658;35604;18318;11542;126721
2003;06;Alpes-Maritimes;230731;118465;112266;258401;276196;164039;115062;1044429
2003;07;Ardèche;69817;35993;33824;70618;82226;45482;28817;296960
2003;08;Ardennes;75757;38881;36876;74470;77812;38437;21344;287820
2003;09;Ariège;30602;15839;14763;31801;39848;23488;16304;142043
2003;10;Aube;74399;38023;36376;76576;80822;39617;24880;296294
2003;11;Aude;73332;37559;35773;76226;88796;53321;34816;326491
2003;12;Aveyron;56084;29037;27047;61395;73071;46666;31898;269114
2003;13;Bouches-du-Rhône;471297;241398;229899;514168;508542;249014;148323;1891344
2003;14;Calvados;172455;87188;85267;179159;176608;83814;49462;661498
2003;15;Cantal;30144;15428;14716;35032;42512;25471;16959;150118
2003;16;Charente;77092;39531;37561;82198;96779;53086;34739;343894
2003;17;Charente-Maritime;129184;66412;62772;135839;159185;95084;60585;579877
2003;18;Cher;72339;36923;35416;74842;87982;49106;30512;314781
2003;19;Corrèze;47328;24629;22699;54223;65721;40651;28882;236805
2003;21;Côte-d'Or;127726;64724;63002;142828;138240;63885;39912;512591
2003;22;Côtes-d'Armor;129964;66771;63193;128531;150834;91765;56737;557831
2003;23;Creuse;23375;12017;11358;25937;33993;23103;17389;123797
2003;24;Dordogne;81914;41890;40024;86526;111355;70146;46964;396905
2003;25;Doubs;132202;67665;64537;144055;134833;63548;33894;508532
2003;26;Drôme;116554;60094;56460;113548;124082;63515;37003;454702
2003;27;Eure;152474;78004;74470;145877;154145;66161;37165;555822
2003;28;Eure-et-Loir;109834;56196;53638;107885;113556;51404;32353;415032
2003;29;Finistère;209465;107484;101981;220709;232676;126975;79380;869205
2003;2A;Corse-du-Sud;28517;14891;13626;31548;36007;20741;11285;128098
2003;2B;Haute-Corse;32995;16958;16037;39485;41644;23305;13500;150929
2003;30;Gard;161980;82683;79297;161126;182186;94502;56098;655892
2003;31;Haute-Garonne;273340;139176;134164;350120;295453;127508;76357;1122778
2003;32;Gers;36607;18718;17889;37996;50251;31395;20936;177185
2003;33;Gironde;322640;164155;158485;380833;367678;166820;107797;1345768
2003;34;Hérault;230518;117510;113008;260772;248575;132418;80582;952865
2003;35;Ille-et-Vilaine;238965;121777;117188;267285;231198;108769;64150;910367
2003;36;Indre;49026;24918;24108;53780;63606;39395;26348;232155
2003;37;Indre-et-Loire;140031;71199;68832;152409;151982;75569;48774;568765
2003;38;Isère;303263;155982;147281;324776;300862;134690;71489;1135080
2003;39;Jura;63292;32589;30703;63003;68935;36334;23127;254691
2003;40;Landes;76746;39768;36978;81885;97085;56379;34525;346620
2003;41;Loir-et-Cher;75016;38209;36807;77313;86666;48955;32586;320536
2003;42;Loire;182022;93378;88644;187869;196322;104772;64795;735780
2003;43;Haute-Loire;50440;26120;24320;51997;58425;33325;20408;214595
2003;44;Loire-Atlantique;312602;159793;152809;331424;317124;143554;84453;1189157
2003;45;Loiret;163580;83820;79760;170342;169841;79594;49662;633019
2003;46;Lot;34094;17563;16531;35616;46192;29826;19765;165493
2003;47;Lot-et-Garonne;70029;35949;34080;71853;86422;51978;34139;314421
2003;48;Lozère;16411;8603;7808;18496;20716;11685;8006;75314
2003;49;Maine-et-Loire;201628;102514;99114;205357;193648;92248;58827;751708
2003;50;Manche;121686;62176;59510;118029;129459;73890;45196;488260
2003;51;Marne;145884;74737;71147;162557;151992;65884;39513;565830
2003;52;Haute-Marne;46529;23993;22536;46856;52581;27896;17045;190907
2003;53;Mayenne;76203;39244;36959;75064;75958;40099;25798;293122
2003;54;Meurthe-et-Moselle;183151;93758;89393;204494;190615;91510;50868;720638
2003;55;Meuse;49183;25512;23671;48905;52617;26567;16049;193321
2003;56;Morbihan;163287;84441;78846;166641;181977;101869;58072;671846
2003;57;Moselle;259218;132870;126348;285216;284398;137727;64862;1031421
2003;58;Nièvre;47434;24257;23177;49146;62271;38954;25800;223605
2003;59;Nord;729134;373055;356079;733976;654214;282437;160110;2559871
2003;60;Oise;221122;113531;107591;217267;216542;82819;43712;781462
2003;61;Orne;71965;37048;34917;69983;78895;44584;27731;293158
2003;62;Pas-de-Calais;404319;207138;197181;387638;381118;173484;102198;1448757
2003;63;Puy-de-Dôme;139370;71153;68217;166598;173134;84759;50827;614688
2003;64;Pyrénées-Atlantiques;139411;71668;67743;155362;169962;95139;60334;620208
2003;65;Hautes-Pyrénées;47472;24536;22936;51820;64102;37698;24319;225411
2003;66;Pyrénées-Orientales;93479;47633;45846;98029;108273;69868;44307;413956
2003;67;Bas-Rhin;267045;135954;131091;312644;282832;128541;64828;1055890
2003;68;Haut-Rhin;184908;94460;90448;199933;199154;93713;45977;723685
2003;69;Rhône;425834;215933;209901;487209;413278;192478;109352;1628151
2003;70;Haute-Saône;58229;30083;28146;58392;64842;32392;19354;233209
2003;71;Saône-et-Loire;125604;64789;60815;129146;152256;85249;55277;547532
2003;72;Sarthe;137792;70448;67344;140770;143100;74182;47193;543037
2003;73;Savoie;97337;50544;46793;105706;106857;50695;28949;389544
2003;74;Haute-Savoie;175857;90996;84861;189470;185809;76352;39672;667160
2003;75;Paris;421482;212283;209199;775126;559029;238077;160807;2154521
2003;76;Seine-Maritime;331079;168554;162525;337704;332321;151106;89892;1242102
2003;77;Seine-et-Marne;361293;184414;176879;355631;345591;115289;59711;1237515
2003;78;Yvelines;387528;198697;188831;387169;385860;146114;70589;1377260
2003;79;Deux-Sèvres;83202;42991;40211;87017;96115;52101;34535;352970
2003;80;Somme;145964;74437;71527;155418;147868;69365;42351;560966
2003;81;Tarn;79384;40763;38621;82380;97123;57540;38816;355243
2003;82;Tarn-et-Garonne;51398;26334;25064;52562;59377;32666;21289;217292
2003;83;Var;219020;112130;106890;223518;255462;155572;92700;946272
2003;84;Vaucluse;132551;68084;64467;131128;140586;72244;41811;518320
2003;85;Vendée;136991;70169;66822;142263;152566;87669;51162;570651
2003;86;Vienne;96856;48991;47865;112071;107470;56141;37193;409731
2003;87;Haute-Vienne;75828;38734;37094;92427;99563;54755;38176;360749
2003;88;Vosges;95208;49077;46131;94993;104771;53612;32055;380639
2003;89;Yonne;81627;41763;39864;80766;91953;49393;33290;337029
2003;90;Territoire de Belfort;35767;18511;17256;39235;37607;17203;9738;139550
2003;91;Essonne;327713;167210;160503;340363;321759;122449;57256;1169540
2003;92;Hauts-de-Seine;369246;187750;181496;479197;384062;157655;98445;1488605
2003;93;Seine-Saint-Denis;418759;212887;205872;442888;376521;137957;66804;1442929
2003;94;Val-de-Marne;327087;166537;160550;387536;338967;135318;77782;1266690
2003;95;Val-d'Oise;335448;171423;164025;327771;312731;104858;52206;1133014
2003;971;Guadeloupe;124827;63762;61065;110318;99649;39550;20537;394881
2003;972;Martinique;116619;58691;57928;107397;101527;44169;21964;391676
2003;973;Guyane;82791;41871;40920;55435;36028;7497;3041;184792
2003;974;La Réunion;273105;138909;134196;231657;168327;56076;21675;750840
2004;01;Ain;149676;76720;72956;146231;153657;64494;36881;550939
2004;02;Aisne;143713;73218;70495;135672;148122;67118;41839;536464
2004;03;Allier;72122;37039;35083;78053;96508;56728;40136;343547
2004;04;Alpes-de-Haute-Provence;34993;18023;16970;33423;42620;24332;14683;150051
2004;05;Hautes-Alpes;30753;15801;14952;30425;36470;18554;11865;128067
2004;06;Alpes-Maritimes;232855;119700;113155;257725;280288;165632;116682;1053182
2004;07;Ardèche;70520;36385;34135;70037;84058;45750;29656;300021
2004;08;Ardennes;74975;38403;36572;73130;79173;37744;22114;287136
2004;09;Ariège;31016;16024;14992;31569;40666;23437;16683;143371
2004;10;Aube;74325;37966;36359;75726;82133;39488;25482;297154
2004;11;Aude;74496;38084;36412;76252;91014;53817;35688;331267
2004;12;Aveyron;56329;29231;27098;60779;74384;46255;32528;270275
2004;13;Bouches-du-Rhône;474831;243314;231517;511794;515431;251451;152182;1905689
2004;14;Calvados;172700;87313;85387;177030;179723;84239;51077;664769
2004;15;Cantal;29937;15315;14622;34332;43148;25083;17444;149944
2004;16;Charente;76689;39312;37377;81135;98387;53108;35389;344708
2004;17;Charente-Maritime;130071;66804;63267;135526;162258;95733;62494;586082
2004;18;Cher;72068;36769;35299;73851;88857;48814;30900;314490
2004;19;Corrèze;47320;24653;22667;53869;66773;40238;29623;237823
2004;21;Côte-d'Or;127953;64858;63095;140935;140287;64073;40774;514022
2004;22;Côtes-d'Armor;130971;67335;63636;127456;153880;91368;58551;562226
2004;23;Creuse;23336;11987;11349;25433;34570;22548;17674;123561
2004;24;Dordogne;82278;42040;40238;85404;113493;69904;47915;398994
2004;25;Doubs;132199;67690;64509;143184;136829;63699;34883;510794
2004;26;Drôme;117164;60424;56740;113037;126491;64278;38106;459076
2004;27;Eure;152760;78177;74583;144838;157064;66644;38087;559393
2004;28;Eure-et-Loir;109687;56206;53481;107271;115392;51234;33224;416808
2004;29;Finistère;210242;108032;102210;218311;237237;125898;81880;873568
2004;2A;Corse-du-Sud;28582;14935;13647;31806;37208;21128;11889;130613
2004;2B;Haute-Corse;33155;17027;16128;39805;42786;23699;13914;153359
2004;30;Gard;163866;83750;80116;160872;186296;95979;57609;664622
2004;31;Haute-Garonne;279851;142353;137498;352406;303388;129761;78300;1143706
2004;32;Gers;36938;18881;18057;37523;51274;31290;21490;178515
2004;33;Gironde;326702;166134;160568;380550;374980;168182;110811;1361225
2004;34;Hérault;234901;119621;115280;261290;254210;135014;83061;968476
2004;35;Ille-et-Vilaine;242483;123518;118965;267557;236705;109009;66157;921911
2004;36;Indre;49029;24905;24124;52777;64534;39031;26840;232211
2004;37;Indre-et-Loire;140806;71652;69154;151146;154285;76039;49979;572255
2004;38;Isère;306385;157641;148744;323486;305929;136469;73628;1145897
2004;39;Jura;63286;32510;30776;62164;70020;36304;23762;255536
2004;40;Landes;77909;40369;37540;81569;99837;56807;35705;351827
2004;41;Loir-et-Cher;75200;38287;36913;76403;88250;48623;33332;321808
2004;42;Loire;181733;93438;88295;186156;198560;104531;66317;737297
2004;43;Haute-Loire;50818;26315;24503;51528;59830;32987;21002;216165
2004;44;Loire-Atlantique;315981;161475;154506;331897;323914;144487;87195;1203474
2004;45;Loiret;164309;84181;80128;169415;172423;79765;50795;636707
2004;46;Lot;34330;17669;16661;35233;47269;29848;20193;166873
2004;47;Lot-et-Garonne;70167;36064;34103;71570;87966;51918;35251;316872
2004;48;Lozère;16527;8731;7796;18313;21156;11665;8123;75784
2004;49;Maine-et-Loire;202546;103015;99531;203823;197417;92126;60341;756253
2004;50;Manche;121036;61932;59104;116189;132338;73074;46971;489608
2004;51;Marne;145135;74313;70822;160367;153964;65643;40403;565512
2004;52;Haute-Marne;45700;23555;22145;45749;53317;27566;17463;189795
2004;53;Mayenne;76440;39308;37132;74516;77573;39764;26520;294813
2004;54;Meurthe-et-Moselle;182970;93785;89185;202507;193557;90293;52407;721734
2004;55;Meuse;48815;25325;23490;48432;53772;25967;16390;193376
2004;56;Morbihan;164331;84988;79343;165914;186801;102093;60233;679372
2004;57;Moselle;257240;131870;125370;281618;290467;136134;67175;1032634
2004;58;Nièvre;46969;24013;22956;48150;63030;38473;26428;223050
2004;59;Nord;725701;371524;354177;727365;664292;278455;165225;2561038
2004;60;Oise;220878;113349;107529;215707;220103;83504;44815;785007
2004;61;Orne;71351;36749;34602;68887;80119;44137;28558;293052
2004;62;Pas-de-Calais;401299;205858;195441;384079;388402;170437;105293;1449510
2004;63;Puy-de-Dôme;139962;71555;68407;165282;174963;85033;52208;617448
2004;64;Pyrénées-Atlantiques;140231;72112;68119;154563;173608;95080;62187;625669
2004;65;Hautes-Pyrénées;47541;24575;22966;50785;65085;37850;24871;226132
2004;66;Pyrénées-Orientales;95065;48433;46632;98049;111165;70239;45302;419820
2004;67;Bas-Rhin;268402;136557;131845;310146;289038;129088;66600;1063274
2004;68;Haut-Rhin;184996;94584;90412;198345;202992;93769;47769;727871
2004;69;Rhône;428999;217646;211353;487139;418485;193763;112490;1640876
2004;70;Haute-Saône;58085;30001;28084;57884;66011;32217;19794;233991
2004;71;Saône-et-Loire;124971;64545;60426;127151;154481;84609;56448;547660
2004;72;Sarthe;138782;70907;67875;139474;145701;73916;48397;546270
2004;73;Savoie;98158;51139;47019;105373;109249;51108;29980;393868
2004;74;Haute-Savoie;177621;92030;85591;189647;190521;78046;40920;676755
2004;75;Paris;425154;214180;210974;774514;562437;239200;160627;2161932
2004;76;Seine-Maritime;329189;167421;161768;333592;336389;151035;92193;1242398
2004;77;Seine-et-Marne;362946;185212;177734;355437;352019;117438;61025;1248865
2004;78;Yvelines;388266;199062;189204;384498;388988;148651;72742;1383145
2004;79;Deux-Sèvres;83388;43153;40235;86432;97966;51935;35193;354914
2004;80;Somme;145989;74442;71547;153400;150194;68863;43492;561938
2004;81;Tarn;80180;41121;39059;81758;99096;57345;40016;358395
2004;82;Tarn-et-Garonne;52255;26778;25477;52585;60916;32705;21855;220316
2004;83;Var;220702;113023;107679;223204;261210;158026;95603;958745
2004;84;Vaucluse;133447;68638;64809;130606;143060;73338;42947;523398
2004;85;Vendée;138464;70937;67527;142383;157108;88273;52746;578974
2004;86;Vienne;97675;49464;48211;111275;109337;56099;37930;412316
2004;87;Haute-Vienne;76360;38989;37371;91570;100877;54490;39225;362522
2004;88;Vosges;94476;48722;45754;93391;106624;52945;32956;380392
2004;89;Yonne;81280;41531;39749;79757;93641;49043;34003;337724
2004;90;Territoire de Belfort;35804;18589;17215;38957;38195;17122;10079;140157
2004;91;Essonne;329952;168465;161487;339030;325717;124497;59018;1178214
2004;92;Hauts-de-Seine;374371;190380;183991;480531;390511;157696;100459;1503568
2004;93;Seine-Saint-Denis;423538;215236;208302;445687;382755;137770;68331;1458081
2004;94;Val-de-Marne;330222;168213;162009;386990;344177;135513;79255;1276157
2004;95;Val-d'Oise;336520;172073;164447;327161;317238;105609;53800;1140328
2004;971;Guadeloupe;124310;63484;60826;107600;103377;40302;21403;396992
2004;972;Martinique;116061;58427;57634;104798;105488;44899;22606;393852
2004;973;Guyane;86674;43840;42834;57302;38022;7951;3218;193167
2004;974;La Réunion;274589;139757;134832;230017;176332;57948;22744;761630
2005;01;Ain;151471;77639;73832;146125;157308;65923;38141;558968
2005;02;Aisne;142747;72764;69983;134079;150175;66443;43354;536798
2005;03;Allier;71918;36909;35009;76599;97599;56287;41155;343558
2005;04;Alpes-de-Haute-Provence;35305;18244;17061;33300;43795;24726;15250;152376
2005;05;Hautes-Alpes;30846;15877;14969;30239;37283;18820;12265;129453
2005;06;Alpes-Maritimes;235361;121009;114352;256715;284825;167182;119417;1063500
2005;07;Ardèche;71048;36672;34376;69368;86049;46030;30622;303117
2005;08;Ardennes;74048;37922;36126;71874;80394;37263;22846;286425
2005;09;Ariège;31450;16225;15225;31374;41628;23363;17073;144888
2005;10;Aube;74168;37881;36287;75072;83362;39590;26291;298483
2005;11;Aude;75607;38629;36978;76221;93314;54249;36846;336237
2005;12;Aveyron;56610;29384;27226;60136;75837;46099;33297;271979
2005;13;Bouches-du-Rhône;477915;244969;232946;510014;521846;254789;157257;1921821
2005;14;Calvados;172727;87352;85375;175333;182751;84505;52894;668210
2005;15;Cantal;29817;15224;14593;33616;43723;24850;17824;149830
2005;16;Charente;76405;39084;37321;80153;99838;53161;36354;345911
2005;17;Charente-Maritime;130985;67261;63724;134823;165787;96349;64696;592640
2005;18;Cher;71839;36642;35197;72681;89837;48697;31588;314642
2005;19;Corrèze;47424;24742;22682;53518;67897;39957;30389;239185
2005;21;Côte-d'Or;127790;64727;63063;139605;142152;64331;41951;515829
2005;22;Côtes-d'Armor;131950;67913;64037;126460;156897;90972;60409;566688
2005;23;Creuse;23290;11961;11329;24878;35188;22038;18029;123423
2005;24;Dordogne;82875;42337;40538;84134;115611;69889;49098;401607
2005;25;Doubs;132318;67771;64547;142597;138404;64096;36156;513571
2005;26;Drôme;117781;60774;57007;112496;128973;65307;39419;463976
2005;27;Eure;152948;78253;74695;143773;160078;67231;39286;563316
2005;28;Eure-et-Loir;109506;56132;53374;106779;117026;51258;34399;418968
2005;29;Finistère;210814;108339;102475;216126;241946;125218;84428;878532
2005;2A;Corse-du-Sud;28657;15035;13622;31913;38419;21647;12492;133128
2005;2B;Haute-Corse;33419;17140;16279;39904;44056;24086;14499;155964
2005;30;Gard;165827;84812;81015;160894;190340;97702;59299;674062
2005;31;Haute-Garonne;285857;145544;140313;354677;312110;131767;80782;1165193
2005;32;Gers;37333;19070;18263;37028;52376;31144;22114;179995
2005;33;Gironde;330394;167814;162580;380716;382383;170085;114413;1377991
2005;34;Hérault;238996;121654;117342;262092;260187;137744;86094;985113
2005;35;Ille-et-Vilaine;245685;125025;120660;267951;242571;109129;68549;933885
2005;36;Indre;49123;24888;24235;51768;65434;38727;27560;232612
2005;37;Indre-et-Loire;141241;71860;69381;150069;156895;76688;51473;576366
2005;38;Isère;309331;159224;150107;322666;311157;138534;76215;1157903
2005;39;Jura;63301;32536;30765;61285;71080;36476;24425;256567
2005;40;Landes;79207;41028;38179;81320;102747;57175;37095;357544
2005;41;Loir-et-Cher;75430;38376;37054;75608;89666;48512;34273;323489
2005;42;Loire;181560;93512;88048;184550;200205;104688;68390;739393
2005;43;Haute-Loire;51280;26544;24736;50884;61260;32810;21586;217820
2005;44;Loire-Atlantique;319282;163153;156129;332491;331087;145633;90317;1218810
2005;45;Loiret;164967;84565;80402;168829;174706;80228;52439;641169
2005;46;Lot;34463;17804;16659;34859;48412;29753;20784;168271
2005;47;Lot-et-Garonne;70561;36334;34227;70867;89888;51961;36442;319719
2005;48;Lozère;16585;8795;7790;18225;21603;11689;8196;76298
2005;49;Maine-et-Loire;203411;103491;99920;202225;201350;92258;62285;761529
2005;50;Manche;120377;61648;58729;114483;135040;72465;48745;491110
2005;51;Marne;144208;73832;70376;158605;155462;65647;41753;565675
2005;52;Haute-Marne;44858;23088;21770;44943;53832;27264;17920;188817
2005;53;Mayenne;76751;39482;37269;73945;79182;39602;27404;296884
2005;54;Meurthe-et-Moselle;182533;93535;88998;201173;196109;89584;54398;723797
2005;55;Meuse;48535;25200;23335;47975;54645;25636;16846;193637
2005;56;Morbihan;165464;85647;79817;165164;191822;102628;62402;687480
2005;57;Moselle;255177;130788;124389;278439;296541;134714;69897;1034768
2005;58;Nièvre;46571;23778;22793;47145;63825;38015;27155;222711
2005;59;Nord;721083;369501;351582;722933;672330;276814;170726;2563886
2005;60;Oise;220433;113056;107377;214226;223642;84277;46434;789012
2005;61;Orne;70787;36485;34302;67710;81335;43711;29562;293105
2005;62;Pas-de-Calais;398477;204396;194081;381137;395007;168025;109081;1451727
2005;63;Puy-de-Dôme;140426;71737;68689;164091;176663;85638;53753;620571
2005;64;Pyrénées-Atlantiques;140989;72491;68498;153464;177443;95453;63986;631335
2005;65;Hautes-Pyrénées;47725;24714;23011;49725;66215;37748;25670;227083
2005;66;Pyrénées-Orientales;96474;49175;47299;98008;114192;70623;46711;426008
2005;67;Bas-Rhin;269039;136708;132331;308041;296451;128839;68790;1071160
2005;68;Haut-Rhin;184842;94452;90390;196611;207490;93469;49830;732242
2005;69;Rhône;431946;219126;212820;487219;423814;195529;116703;1655211
2005;70;Haute-Saône;58071;30006;28065;57264;67050;32363;20186;234934
2005;71;Saône-et-Loire;124462;64245;60217;125017;156409;84520;58259;548667
2005;72;Sarthe;139603;71235;68368;138452;148470;73579;49963;550067
2005;73;Savoie;99054;51638;47416;104987;111620;51674;31211;398546
2005;74;Haute-Savoie;179303;92955;86348;189904;194872;79962;42581;686622
2005;75;Paris;428463;216100;212363;774451;565574;241161;162537;2172186
2005;76;Seine-Maritime;326602;166028;160574;330516;339506;151558;95179;1243361
2005;77;Seine-et-Marne;364360;185868;178492;356028;357882;119712;63028;1261010
2005;78;Yvelines;388272;199093;189179;382393;391842;151438;75511;1389456
2005;79;Deux-Sèvres;83851;43432;40419;85654;100047;51417;36350;357319
2005;80;Somme;145604;74315;71289;151918;152210;68840;44646;563218
2005;81;Tarn;80905;41480;39425;81190;101237;57248;41352;361932
2005;82;Tarn-et-Garonne;53219;27338;25881;52730;62474;32800;22509;223732
2005;83;Var;222517;113939;108578;222986;267046;160471;99359;972379
2005;84;Vaucluse;134432;69313;65119;129896;145728;74504;44475;529035
2005;85;Vendée;140142;71759;68383;142419;161997;88654;54889;588101
2005;86;Vienne;98190;49793;48397;110620;111464;56148;39015;415437
2005;87;Haute-Vienne;76921;39384;37537;90873;102450;54314;40321;364879
2005;88;Vosges;93796;48370;45426;91766;108284;52463;33957;380266
2005;89;Yonne;80986;41298;39688;78969;95253;48634;35141;338983
2005;90;Territoire de Belfort;35649;18545;17104;38709;38697;17223;10394;140672
2005;91;Essonne;332438;169770;162668;337861;329762;126802;61488;1188351
2005;92;Hauts-de-Seine;379221;192884;186337;481858;396945;158337;103745;1520106
2005;93;Seine-Saint-Denis;428431;217642;210789;449083;388274;138456;70676;1474920
2005;94;Val-de-Marne;332978;169783;163195;387046;349214;136195;81917;1287350
2005;95;Val-d'Oise;337951;172763;165188;326727;321227;107093;55766;1148764
2005;971;Guadeloupe;124155;63488;60667;104562;106609;41740;22112;399178
2005;972;Martinique;115247;58068;57179;102449;108876;46061;23349;395982
2005;973;Guyane;89056;45094;43962;58770;39614;8353;3413;199206
2005;974;La Réunion;275410;140360;135050;229240;184544;59941;23772;772907
2006;01;Ain;152564;78181;74383;146329;160690;66927;40230;566740
2006;02;Aisne;141723;72541;69182;132064;152396;66219;44659;537061
2006;03;Allier;71834;36854;34980;75578;98440;55656;41801;343309
2006;04;Alpes-de-Haute-Provence;36047;18635;17412;33002;44789;24983;15680;154501
2006;05;Hautes-Alpes;31176;15989;15187;29853;37934;19128;12661;130752
2006;06;Alpes-Maritimes;237971;122206;115765;256807;289337;167748;121321;1073184
2006;07;Ardèche;71763;36964;34799;68840;87513;46299;31823;306238
2006;08;Ardennes;73566;37932;35634;70314;81440;36902;23431;285653
2006;09;Ariège;31810;16339;15471;31330;42582;23098;17469;146289
2006;10;Aube;74016;37827;36189;74770;84671;39602;26645;299704
2006;11;Aude;75872;38752;37120;76923;95357;54418;38452;341022
2006;12;Aveyron;56837;29360;27477;59803;76928;45293;34516;273377
2006;13;Bouches-du-Rhône;479982;245452;234530;510603;526532;257243;163045;1937405
2006;14;Calvados;172210;87467;84743;174640;185310;84372;54819;671351
2006;15;Cantal;29331;15077;14254;33172;44142;24686;18351;149682
2006;16;Charente;76720;39348;37372;79041;101346;52260;37670;347037
2006;17;Charente-Maritime;131164;67275;63889;135185;169490;96722;66354;598915
2006;18;Cher;71005;35976;35029;71708;90713;48668;32581;314675
2006;19;Corrèze;47512;24521;22991;53655;68819;39171;31206;240363
2006;21;Côte-d'Or;126456;64124;62332;139093;143530;64476;43613;517168
2006;22;Côtes-d'Armor;132819;68487;64332;125920;159578;90128;62416;570861
2006;23;Creuse;23210;12007;11203;24482;35901;21507;18301;123401
2006;24;Dordogne;83570;42789;40781;82900;117961;69057;50564;404052
2006;25;Doubs;132425;68036;64389;141690;139616;64605;37821;516157
2006;26;Drôme;118024;60944;57080;111907;131109;66218;41350;468608
2006;27;Eure;153417;78608;74809;143181;162311;67768;40544;567221
2006;28;Eure-et-Loir;109196;56218;52978;106453;118552;51725;35188;421114
2006;29;Finistère;211418;108286;103132;214616;246663;123957;86347;883001
2006;2A;Corse-du-Sud;29096;15296;13800;32143;39420;21953;13106;135718
2006;2B;Haute-Corse;34180;17566;16614;39518;45286;24361;15055;158400
2006;30;Gard;167569;85735;81834;161370;194026;98644;61560;683169
2006;31;Haute-Garonne;291059;147989;143070;358968;318300;132278;85725;1186330
2006;32;Gers;37512;19172;18340;36683;53615;30674;22891;181375
2006;33;Gironde;333124;169747;163377;381191;389894;170787;118762;1393758
2006;34;Hérault;242707;123542;119165;263206;266454;139553;89121;1001041
2006;35;Ille-et-Vilaine;247039;125599;121440;271164;247920;108458;71270;945851
2006;36;Indre;49005;24909;24096;51720;65898;38136;28200;232959
2006;37;Indre-et-Loire;143290;72665;70625;148830;159053;76293;52846;580312
2006;38;Isère;308372;158825;149547;324217;315764;139908;81230;1169491
2006;39;Jura;63422;32870;30552;60614;71858;36295;25210;257399
2006;40;Landes;79855;41310;38545;81151;105603;57275;38943;362827
2006;41;Loir-et-Cher;75597;38508;37089;75098;91247;48163;35077;325182
2006;42;Loire;181792;93071;88721;182372;201806;104050;71249;741269
2006;43;Haute-Loire;51705;26600;25105;50517;62250;32385;22627;219484
2006;44;Loire-Atlantique;322638;165074;157564;334874;337550;145620;93403;1234085
2006;45;Loiret;165636;84770;80866;167529;177883;80547;53730;645325
2006;46;Lot;34562;17764;16798;34288;49531;29539;21611;169531
2006;47;Lot-et-Garonne;71795;36891;34904;70779;91028;51263;37427;322292
2006;48;Lozère;16898;8968;7930;17730;22101;11583;8488;76800
2006;49;Maine-et-Loire;204051;104070;99981;201816;204251;92298;64243;766659
2006;50;Manche;119860;61256;58604;112534;138043;71798;50328;492563
2006;51;Marne;143196;73331;69865;156951;156610;66066;43018;565841
2006;52;Haute-Marne;44122;22671;21451;43820;54166;26871;18673;187652
2006;53;Mayenne;78138;40220;37918;72746;80680;39032;28404;299000
2006;54;Meurthe-et-Moselle;181344;92504;88840;200356;198278;88916;56408;725302
2006;55;Meuse;48426;25171;23255;46923;55743;25247;17357;193696
2006;56;Morbihan;166077;85630;80447;164629;196278;103015;64822;694821
2006;57;Moselle;251522;129038;122484;276409;301108;132957;74780;1036776
2006;58;Nièvre;46160;23627;22533;46125;64896;37678;27361;222220
2006;59;Nord;714845;365840;349005;718061;681657;277703;172991;2565257
2006;60;Oise;219109;112092;107017;213362;226824;85177;48503;792975
2006;61;Orne;70192;36127;34065;66402;82643;43108;30534;292879
2006;62;Pas-de-Calais;395967;203015;192952;377761;401635;168868;109156;1453387
2006;63;Puy-de-Dôme;140626;71435;69191;162935;178607;85063;56232;623463
2006;64;Pyrénées-Atlantiques;141407;72844;68563;153050;180903;95217;66272;636849
2006;65;Hautes-Pyrénées;47333;24357;22976;49647;66968;37368;26420;227736
2006;66;Pyrénées-Orientales;97584;49906;47678;98747;116653;70698;48430;432112
2006;67;Bas-Rhin;269189;136963;132226;306264;301909;128347;73307;1079016
2006;68;Haut-Rhin;184340;94345;89995;194901;211283;92351;53602;736477
2006;69;Rhône;432389;219266;213123;489995;428079;196978;122214;1669655
2006;70;Haute-Saône;58194;29989;28205;56638;67862;32309;20864;235867
2006;71;Saône-et-Loire;124301;64279;60022;122623;157976;84205;60256;549361
2006;72;Sarthe;139667;71273;68394;137504;151858;73139;51316;553484
2006;73;Savoie;99559;51504;48055;104960;113642;52446;32483;403090
2006;74;Haute-Savoie;180594;93595;86999;190860;198089;82164;44548;696255
2006;75;Paris;435096;219210;215886;776146;568538;242247;159344;2181371
2006;76;Seine-Maritime;322648;163890;158758;329320;342873;151371;97622;1243834
2006;77;Seine-et-Marne;365124;186367;178757;357742;361968;122256;66398;1273488
2006;78;Yvelines;387879;199327;188552;379628;394638;153872;79787;1395804
2006;79;Deux-Sèvres;84557;43858;40699;84528;101963;51181;37482;359711
2006;80;Somme;144728;73685;71043;151125;154334;69062;45070;564319
2006;81;Tarn;81596;41668;39928;81318;103432;55794;43195;365335
2006;82;Tarn-et-Garonne;53623;27607;26016;53198;63878;32654;23496;226849
2006;83;Var;223373;114306;109067;223251;272809;163032;102634;985099
2006;84;Vaucluse;134478;69039;65439;129937;147981;75305;46590;534291
2006;85;Vendée;142611;73028;69583;142979;165967;88537;57091;597185
2006;86;Vienne;99388;50424;48964;109805;113544;55702;40021;418460
2006;87;Haute-Vienne;77871;39714;38157;90585;103967;53733;41000;367156
2006;88;Vosges;92183;47432;44751;90808;109779;52352;34853;379975
2006;89;Yonne;81010;41570;39440;78073;96626;48711;35668;340088
2006;90;Territoire de Belfort;35195;18267;16928;38903;39275;17234;10594;141201
2006;91;Essonne;331789;169276;162513;339107;333712;128082;65583;1198273
2006;92;Hauts-de-Seine;383790;195112;188678;484928;402952;158477;105953;1536100
2006;93;Seine-Saint-Denis;432584;220303;212281;454114;394306;139022;71944;1491970
2006;94;Val-de-Marne;334385;170617;163768;388893;353961;137027;84074;1298340
2006;95;Val-d'Oise;337810;172686;165124;328244;323885;108429;58684;1157052
2006;971;Guadeloupe;124050;63601;60449;101499;109121;44114;21952;400736
2006;972;Martinique;114809;58288;56521;99421;111263;47758;24481;397732
2006;973;Guyane;92528;46744;45784;60648;40878;8896;3004;205954
2006;974;La Réunion;275965;140283;135682;227033;192735;62458;23771;781962
2007;01;Ain;153719;78672;75047;147284;163003;68837;41534;574377
2007;02;Aisne;141079;72302;68777;131304;152341;67757;45339;537820
2007;03;Allier;71446;36753;34693;74685;97923;56218;42842;343114
2007;04;Alpes-de-Haute-Provence;35905;18655;17250;32707;45416;25895;16144;156067
2007;05;Hautes-Alpes;31075;15812;15263;29774;38809;19827;12997;132482
2007;06;Alpes-Maritimes;239703;123223;116480;256608;292526;169954;123674;1082465
2007;07;Ardèche;72224;37166;35058;68567;88303;47712;32650;309456
2007;08;Ardennes;72858;37698;35160;69172;81450;37288;23981;284749
2007;09;Ariège;32029;16413;15616;31680;43092;23647;18120;148568
2007;10;Aube;73707;37515;36192;74864;84398;40502;27369;300840
2007;11;Aude;77876;40068;37808;76345;96123;55928;39507;345779
2007;12;Aveyron;57331;29592;27739;58899;77179;45668;35348;274425
2007;13;Bouches-du-Rhône;482779;246836;235943;512459;532223;264067;167398;1958926
2007;14;Calvados;170591;86929;83662;174239;185816;86608;56413;673667
2007;15;Cantal;29307;15084;14223;31926;44099;24922;18803;149057
2007;16;Charente;76452;39341;37111;78949;101896;53555;38683;349535
2007;17;Charente-Maritime;132985;68480;64505;133640;170408;99787;68590;605410
2007;18;Cher;70167;35664;34503;71131;90397;49568;33336;314599
2007;19;Corrèze;47972;24766;23206;53659;69022;39795;31590;242038
2007;21;Côte-d'Or;124994;63494;61500;139443;143617;66344;44745;519143
2007;22;Côtes-d'Armor;133672;68935;64737;125334;160378;92412;64253;576049
2007;23;Creuse;23793;12364;11429;23731;36180;21643;18514;123861
2007;24;Dordogne;83418;42578;40840;82308;118201;70820;52046;406793
2007;25;Doubs;132988;68518;64470;141041;140229;66571;39304;520133
2007;26;Drôme;118771;61254;57517;111909;132435;67811;42502;473428
2007;27;Eure;153929;78797;75132;143293;163096;70012;41775;572105
2007;28;Eure-et-Loir;108764;55889;52875;105757;118780;52986;36124;422411
2007;29;Finistère;211197;108125;103072;213372;246865;126252;88220;885906
2007;2A;Corse-du-Sud;29598;15416;14182;32857;40518;22564;13825;139362
2007;2B;Haute-Corse;33711;17443;16268;40289;45351;25106;15390;159847
2007;30;Gard;167878;86071;81807;161679;195803;101240;63247;689847
2007;31;Haute-Garonne;294252;150108;144144;360344;323835;136773;87716;1202920
2007;32;Gers;38075;19474;18601;36590;54212;31016;23722;183615
2007;33;Gironde;335802;171252;164550;383734;392433;176475;120901;1409345
2007;34;Hérault;242372;123435;118937;264751;268298;143457;92329;1011207
2007;35;Ille-et-Vilaine;250970;128249;122721;268714;251468;111337;73357;955846
2007;36;Indre;49136;25059;24077;50387;65812;38773;28691;232799
2007;37;Indre-et-Loire;142963;72816;70147;149154;159279;77907;53783;583086
2007;38;Isère;311239;160171;151068;321129;317897;144150;84299;1178714
2007;39;Jura;63377;32719;30658;60038;72377;37114;25991;258897
2007;40;Landes;81573;42194;39379;81343;106552;58538;39486;367492
2007;41;Loir-et-Cher;75873;38815;37058;73964;91401;49139;35914;326291
2007;42;Loire;181288;92694;88594;181029;200415;105380;72556;740668
2007;43;Haute-Loire;51839;26609;25230;50017;62410;33242;22929;220437
2007;44;Loire-Atlantique;323801;165435;158366;337407;339937;149527;96126;1246798
2007;45;Loiret;164944;84344;80600;167801;177466;83089;54433;647733
2007;46;Lot;34879;18022;16857;33916;49724;30290;22364;171173
2007;47;Lot-et-Garonne;71243;36811;34432;70508;91523;52656;38240;324170
2007;48;Lozère;16529;8735;7794;17559;22195;11889;8708;76880
2007;49;Maine-et-Loire;205802;104884;100918;199885;205023;94421;65646;770777
2007;50;Manche;119832;61425;58407;111453;138936;72967;51965;495153
2007;51;Marne;142749;73018;69731;155488;156017;68220;44017;566491
2007;52;Haute-Marne;43734;22459;21275;43142;54189;27466;18876;187407
2007;53;Mayenne;78305;40378;37927;72305;81344;39641;29048;300643
2007;54;Meurthe-et-Moselle;179362;91525;87837;200295;197759;90863;58313;726592
2007;55;Meuse;47929;24882;23047;46889;55543;25745;17856;193962
2007;56;Morbihan;167014;86364;80650;163638;198059;106129;67647;702487
2007;57;Moselle;248901;127763;121138;275140;303189;134170;77623;1039023
2007;58;Nièvre;45765;23511;22254;45298;64497;38191;27737;221488
2007;59;Nord;706829;362045;344784;717069;679229;283683;178140;2564950
2007;60;Oise;218934;112245;106689;212289;227189;88197;50015;796624
2007;61;Orne;69583;35854;33729;65312;82302;43983;31429;292609
2007;62;Pas-de-Calais;393503;201817;191686;377330;400857;172403;112633;1456726
2007;63;Puy-de-Dôme;140010;71029;68981;162636;178880;87552;57561;626639
2007;64;Pyrénées-Atlantiques;142810;73501;69309;152101;183055;96735;68389;643090
2007;65;Hautes-Pyrénées;47961;24661;23300;48611;67085;37800;27137;228594
2007;66;Pyrénées-Orientales;98271;50291;47980;99343;117857;72046;49640;437157
2007;67;Bas-Rhin;268677;136664;132013;302665;306397;130537;76564;1084840
2007;68;Haut-Rhin;184458;94408;90050;194216;214104;93850;55780;742408
2007;69;Rhône;433417;219908;213509;489006;426882;201024;126744;1677073
2007;70;Haute-Saône;58134;30102;28032;56388;67885;33352;21438;237197
2007;71;Saône-et-Loire;125167;65013;60154;121118;158151;86064;61342;551842
2007;72;Sarthe;140646;71931;68715;136330;152577;74745;52648;556946
2007;73;Savoie;100535;51979;48556;103285;114594;53407;33714;405535
2007;74;Haute-Savoie;183196;94787;88409;191260;201209;84925;46118;706708
2007;75;Paris;435141;219081;216060;778460;567554;250518;161357;2193030
2007;76;Seine-Maritime;320792;163319;157473;326286;341349;155322;100862;1244611
2007;77;Seine-et-Marne;368456;188388;180068;360485;364330;127310;68943;1289524
2007;78;Yvelines;389566;199725;189841;377698;393763;159240;83690;1403957
2007;79;Deux-Sèvres;85136;44043;41093;84729;102520;52382;38177;362944
2007;80;Somme;143528;73414;70114;150390;154166;71245;46581;565910
2007;81;Tarn;82856;42522;40334;81186;104260;56829;44058;369189
2007;82;Tarn-et-Garonne;55476;28454;27022;53628;65506;33394;23759;231763
2007;83;Var;224781;115568;109213;222986;274293;168230;105644;995934
2007;84;Vaucluse;134963;69368;65595;128991;148999;77574;47614;538141
2007;85;Vendée;145060;74310;70750;143469;168273;91754;58874;607430
2007;86;Vienne;99532;50293;49239;110789;114154;56671;40745;421891
2007;87;Haute-Vienne;78427;39932;38495;90689;104475;55083;42428;371102
2007;88;Vosges;92401;47480;44921;88974;109578;53457;35894;380304
2007;89;Yonne;81181;41636;39545;77264;96684;49926;36363;341418
2007;90;Territoire de Belfort;35387;18272;17115;38979;39439;17684;10955;142444
2007;91;Essonne;332558;169929;162629;335696;333992;131849;67899;1201994
2007;92;Hauts-de-Seine;387563;196992;190571;482086;404814;161518;108430;1544411
2007;93;Seine-Saint-Denis;435109;221580;213529;454414;397098;140966;74753;1502340
2007;94;Val-de-Marne;337525;173008;164517;386148;354070;139829;85317;1302889
2007;95;Val-d'Oise;336059;172309;163750;328308;323309;112904;60141;1160721
2007;971;Guadeloupe;122977;63118;59859;98651;110972;45406;22578;400584
2007;972;Martinique;113813;57391;56422;97129;113223;48495;25070;397730
2007;973;Guyane;94722;47623;47099;63937;41967;9220;3185;213031
2007;974;La Réunion;278190;141874;136316;227692;200272;63748;24205;794107
2008;01;Ain;154826;79177;75649;147366;164828;71681;42654;581355
2008;02;Aisne;140544;71937;68607;131229;151630;69382;46005;538790
2008;03;Allier;71480;36812;34668;73290;97231;57314;43492;342807
2008;04;Alpes-de-Haute-Provence;36266;18840;17426;32664;45454;26838;16743;157965
2008;05;Hautes-Alpes;31318;15955;15363;29360;39384;20677;13466;134205
2008;06;Alpes-Maritimes;238363;122804;115559;254862;292633;172567;126003;1084428
2008;07;Ardèche;72753;37393;35360;67836;88287;49187;33389;311452
2008;08;Ardennes;72286;37520;34766;68842;80977;37600;24492;284197
2008;09;Ariège;32346;16621;15725;32120;43332;24008;18395;150201
2008;10;Aube;74148;37988;36160;73981;83549;41805;27844;301327
2008;11;Aude;78326;40033;38293;76147;96438;57768;40558;349237
2008;12;Aveyron;58025;29974;28051;57907;77227;46347;36383;275889
2008;13;Bouches-du-Rhône;483099;247275;235824;509802;531957;270755;170392;1966005
2008;14;Calvados;172818;88033;84785;172121;185551;89406;58310;678206
2008;15;Cantal;29055;14933;14122;31520;43867;25025;19270;148737
2008;16;Charente;76795;39385;37410;77997;102027;54925;39837;351581
2008;17;Charente-Maritime;133289;68720;64569;133797;169948;103604;71076;611714
2008;18;Cher;69336;35436;33900;69741;89562;50514;34098;313251
2008;19;Corrèze;49356;25755;23601;52043;68978;40298;32221;242896
2008;21;Côte-d'Or;125135;63491;61644;138039;143695;68552;46187;521608
2008;22;Côtes-d'Armor;135907;70006;65901;124751;160830;94996;65086;581570
2008;23;Creuse;23712;12210;11502;23610;35878;22162;18545;123907
2008;24;Dordogne;84076;42974;41102;81550;118200;72519;53043;409388
2008;25;Doubs;132405;68191;64214;141106;139801;68636;40737;522685
2008;26;Drôme;119620;61568;58052;111908;133109;70062;43370;478069
2008;27;Eure;154353;78940;75413;143543;163513;73027;42651;577087
2008;28;Eure-et-Loir;108430;55552;52878;105077;118848;54453;36751;423559
2008;29;Finistère;210898;108361;102537;212874;247660;129717;89360;890509
2008;2A;Corse-du-Sud;29550;15309;14241;32696;41309;23175;14223;140953
2008;2B;Haute-Corse;33481;17320;16161;40763;46029;26014;15726;162013
2008;30;Gard;169156;86592;82564;160477;196045;103920;64725;694323
2008;31;Haute-Garonne;297302;152231;145071;362769;325773;141516;89984;1217344
2008;32;Gers;38428;19567;18861;36535;54273;31672;24358;185266
2008;33;Gironde;337949;172269;165680;383529;392394;183629;123775;1421276
2008;34;Hérault;241693;123113;118580;265875;268869;148687;94674;1019798
2008;35;Ille-et-Vilaine;252969;129010;123959;269622;253673;115077;76247;967588
2008;36;Indre;48645;24848;23797;49273;65478;39254;29354;232004
2008;37;Indre-et-Loire;142015;72457;69558;148869;159210;80073;55239;585406
2008;38;Isère;313239;161360;151879;319149;319546;149464;87262;1188660
2008;39;Jura;63845;32909;30936;59626;72523;38276;26470;260740
2008;40;Landes;83039;42828;40211;82183;107536;60426;39958;373142
2008;41;Loir-et-Cher;76018;38941;37077;72093;91293;50268;36927;326599
2008;42;Loire;181019;92479;88540;179646;199089;108476;73846;742076
2008;43;Haute-Loire;52453;26959;25494;49194;62639;34219;23329;221834
2008;44;Loire-Atlantique;327016;167167;159849;335206;339721;154865;99063;1255871
2008;45;Loiret;164364;83900;80464;167688;177159;85544;56014;650769
2008;46;Lot;34912;18033;16879;33715;50021;31236;22912;172796
2008;47;Lot-et-Garonne;71662;37253;34409;70007;91530;53857;39343;326399
2008;48;Lozère;16308;8601;7707;17428;22181;12243;8813;76973
2008;49;Maine-et-Loire;206070;104890;101180;199144;205314;96777;67518;774823
2008;50;Manche;118589;60931;57658;110897;139391;74762;53298;496937
2008;51;Marne;141420;72385;69035;153636;155268;70668;45018;566010
2008;52;Haute-Marne;43169;22163;21006;42604;53573;28040;19084;186470
2008;53;Mayenne;78100;40204;37896;72415;81400;40606;30462;302983
2008;54;Meurthe-et-Moselle;179911;91926;87985;199380;197142;93076;60259;729768
2008;55;Meuse;47406;24562;22844;46922;55368;26260;18262;194218
2008;56;Morbihan;167898;86606;81292;163259;199359;109741;69777;710034
2008;57;Moselle;247287;126948;120339;273578;305317;136192;79856;1042230
2008;58;Nièvre;45337;23190;22147;44473;63636;38902;28305;220653
2008;59;Nord;702810;359874;342936;715658;675782;290368;180341;2564959
2008;60;Oise;218436;111666;106770;212416;226512;91490;50871;799725
2008;61;Orne;69223;35663;33560;63967;81972;44885;32235;292282
2008;62;Pas-de-Calais;391949;201347;190602;376735;400266;176833;113748;1459531
2008;63;Puy-de-Dôme;138948;70638;68310;163161;177961;90152;58263;628485
2008;64;Pyrénées-Atlantiques;143002;73440;69562;151137;183292;99375;70614;647420
2008;65;Hautes-Pyrénées;48214;24949;23265;47928;66686;38161;28090;229079
2008;66;Pyrénées-Orientales;98932;50891;48041;99197;118255;73580;51423;441387
2008;67;Bas-Rhin;268072;136270;131802;301122;309084;133703;79034;1091015
2008;68;Haut-Rhin;183768;94232;89536;192255;216065;95838;58146;746072
2008;69;Rhône;437289;221511;215778;491252;425013;205504;131440;1690498
2008;70;Haute-Saône;58363;30215;28148;55999;67899;34437;21850;238548
2008;71;Saône-et-Loire;124985;64937;60048;120512;157469;88262;62740;553968
2008;72;Sarthe;141016;72081;68935;135223;152834;76589;53925;559587
2008;73;Savoie;100419;51939;48480;103707;115258;54661;34797;408842
2008;74;Haute-Savoie;184655;95404;89251;191581;203859;88816;47366;716277
2008;75;Paris;438248;220761;217487;780427;566535;260902;165185;2211297
2008;76;Seine-Maritime;319253;162237;157016;325037;340938;159610;103742;1248580
2008;77;Seine-et-Marne;370829;189389;181440;363177;365436;133870;70390;1303702
2008;78;Yvelines;387063;198233;188830;374465;392300;164075;88150;1406053
2008;79;Deux-Sèvres;85185;43805;41380;84459;102802;53468;39145;365059
2008;80;Somme;143446;73372;70074;150295;154027;73240;47078;568086
2008;81;Tarn;83662;42935;40727;80424;104183;58239;45230;371738
2008;82;Tarn-et-Garonne;56493;28868;27625;54233;66132;34276;24781;235915
2008;83;Var;223791;115014;108777;221223;273742;173075;109577;1001408
2008;84;Vaucluse;133815;68787;65028;127812;148999;79666;48610;538902
2008;85;Vendée;146478;75208;71270;144744;169195;95453;61036;616906
2008;86;Vienne;99990;50573;49417;109960;114296;58362;41746;424354
2008;87;Haute-Vienne;78493;39828;38665;91250;103965;56594;43638;373940
2008;88;Vosges;91528;47113;44415;87889;109388;54765;36575;380145
2008;89;Yonne;81011;41632;39379;77098;96142;51255;36853;342359
2008;90;Territoire de Belfort;35780;18692;17088;37962;38870;17972;11374;141958
2008;91;Essonne;334102;171021;163081;332394;332529;135648;71177;1205850
2008;92;Hauts-de-Seine;388128;197148;190980;481383;402897;165819;111392;1549619
2008;93;Seine-Saint-Denis;435275;221434;213841;453220;396497;144613;76861;1506466
2008;94;Val-de-Marne;338941;173675;165266;387365;353283;143711;87576;1310876
2008;95;Val-d'Oise;336768;172586;164182;327003;322559;117025;62042;1165397
2008;971;Guadeloupe;122315;62866;59449;96835;112364;46794;23476;401784
2008;972;Martinique;111701;56042;55659;94918;115236;50072;25766;397693
2008;973;Guyane;97230;49041;48189;65337;43598;9786;3315;219266
2008;974;La Réunion;280064;143232;136832;228427;207299;67556;24904;808250
2009;01;Ain;156875;80092;76783;147234;166380;74738;43626;588853
2009;02;Aisne;140108;71798;68310;130650;151050;71463;46599;539870
2009;03;Allier;71746;36844;34902;71728;97005;58555;44012;343046
2009;04;Alpes-de-Haute-Provence;36485;18996;17489;32462;45785;27538;17180;159450
2009;05;Hautes-Alpes;31261;16061;15200;29425;39568;21688;13894;135836
2009;06;Alpes-Maritimes;235569;120813;114756;252371;289638;174679;126843;1079100
2009;07;Ardèche;72885;37465;35420;67104;88571;50756;34262;313578
2009;08;Ardennes;71495;37250;34245;67896;80587;38772;24546;283296
2009;09;Ariège;32414;16800;15614;31759;43334;24858;18752;151117
2009;10;Aube;74797;38245;36552;73165;83540;43478;28318;303298
2009;11;Aude;79366;40443;38923;76394;96931;59586;41703;353980
2009;12;Aveyron;58336;30228;28108;57378;77124;47249;36961;277048
2009;13;Bouches-du-Rhône;480429;245119;235310;504586;530843;276670;174771;1967299
2009;14;Calvados;172025;87754;84271;170600;185233;92725;60325;680908
2009;15;Cantal;28846;14725;14121;31016;43546;25352;19620;148380
2009;16;Charente;76927;39533;37394;76745;101299;56106;40486;351563
2009;17;Charente-Maritime;134424;69524;64900;132458;169672;107702;72351;616607
2009;18;Cher;68962;35332;33630;67542;88028;52149;34341;311022
2009;19;Corrèze;49138;25581;23557;51583;68485;41537;32609;243352
2009;21;Côte-d'Or;125757;63888;61869;136756;143132;71100;47399;524144
2009;22;Côtes-d'Armor;137007;70610;66397;125413;160615;97709;66775;587519
2009;23;Creuse;23488;12067;11421;23132;35588;22597;18779;123584
2009;24;Dordogne;83624;42833;40791;81647;117901;74774;54136;412082
2009;25;Doubs;131997;68095;63902;141542;138935;70976;41826;525276
2009;26;Drôme;120782;62333;58449;111532;134063;72129;44478;482984
2009;27;Eure;155285;79239;76046;143761;163794;76127;43855;582822
2009;28;Eure-et-Loir;109085;56136;52949;104263;118359;56556;37239;425502
2009;29;Finistère;211972;109142;102830;210670;246670;133676;90926;893914
2009;2A;Corse-du-Sud;29265;15285;13980;33050;41248;23396;14371;141330
2009;2B;Haute-Corse;33487;17350;16137;41455;46440;26957;16005;164344
2009;30;Gard;170803;87344;83459;159764;197503;107312;66501;701883
2009;31;Haute-Garonne;298417;152809;145608;365230;327472;147057;92644;1230820
2009;32;Gers;39012;20064;18948;36265;54595;32556;24753;187181
2009;33;Gironde;340935;173831;167104;384307;392150;190617;126652;1434661
2009;34;Hérault;243609;123984;119625;266074;271332;153611;97348;1031974
2009;35;Ille-et-Vilaine;254509;129682;124827;270340;254846;119448;78306;977449
2009;36;Indre;48812;24927;23885;48506;65486;39939;29525;232268
2009;37;Indre-et-Loire;141487;72001;69486;148273;159329;82843;56488;588420
2009;38;Isère;314387;161861;152526;318656;320978;153379;89638;1197038
2009;39;Jura;63560;32788;30772;59024;72317;39373;27003;261277
2009;40;Landes;83857;43036;40821;82614;108358;63211;41301;379341
2009;41;Loir-et-Cher;76579;39295;37284;71445;91129;51301;37414;327868
2009;42;Loire;182287;93435;88852;178610;197980;111228;76010;746115
2009;43;Haute-Loire;52586;27006;25580;48843;62613;35113;23967;223122
2009;44;Loire-Atlantique;327703;167623;160080;336242;339997;161266;101150;1266358
2009;45;Loiret;164957;84671;80286;166733;175800;88486;57534;653510
2009;46;Lot;35602;18304;17298;32902;49955;32329;22774;173562
2009;47;Lot-et-Garonne;72116;37467;34649;69772;91938;55806;40065;329697
2009;48;Lozère;16365;8617;7748;17307;22094;12670;8727;77163
2009;49;Maine-et-Loire;206301;105069;101232;199135;205010;100530;69106;780082
2009;50;Manche;117572;60299;57273;109367;138857;77151;54815;497762
2009;51;Marne;140491;72122;68369;152322;154460;73129;45743;566145
2009;52;Haute-Marne;42556;21868;20688;41686;52793;28902;19277;185214
2009;53;Mayenne;78367;40368;37999;72248;81379;41740;31413;305147
2009;54;Meurthe-et-Moselle;178483;91052;87431;199325;196077;95432;61702;731019
2009;55;Meuse;46784;24206;22578;46758;54963;27029;18469;194003
2009;56;Morbihan;170164;87720;82444;161608;199347;113663;71400;716182
2009;57;Moselle;246122;126516;119606;272761;305123;139232;81660;1044898
2009;58;Nièvre;45445;23270;22175;43505;62762;39746;28741;220199
2009;59;Nord;701016;359352;341664;715501;671480;300062;183881;2571940
2009;60;Oise;217671;111495;106176;210356;226182;95483;51820;801512
2009;61;Orne;69107;35507;33600;63435;81154;45786;32728;292210
2009;62;Pas-de-Calais;389889;199991;189898;374134;399473;182642;115119;1461257
2009;63;Puy-de-Dôme;140900;71524;69376;159662;176801;93278;58775;629416
2009;64;Pyrénées-Atlantiques;143809;74070;69739;149521;183725;101643;71658;650356
2009;65;Hautes-Pyrénées;48171;24887;23284;47768;66197;38992;28542;229670
2009;66;Pyrénées-Orientales;100682;51853;48829;98838;118785;75675;51910;445890
2009;67;Bas-Rhin;266037;135612;130425;299239;310288;137930;80945;1094439
2009;68;Haut-Rhin;183821;94227;89594;189782;216977;98522;59512;748614
2009;69;Rhône;440207;222769;217438;498109;426247;210625;133483;1708671
2009;70;Haute-Saône;58313;30153;28160;55168;67861;35772;22080;239194
2009;71;Saône-et-Loire;124420;64535;59885;119004;156837;90386;64073;554720
2009;72;Sarthe;140830;72007;68823;134182;152436;78636;54966;561050
2009;73;Savoie;100663;52002;48661;102995;115615;56733;35001;411007
2009;74;Haute-Savoie;185761;95984;89777;192769;205947;91784;49533;725794
2009;75;Paris;444286;222375;221911;785061;566908;271489;166361;2234105
2009;76;Seine-Maritime;318228;162059;156169;322904;339222;164225;105541;1250120
2009;77;Seine-et-Marne;371860;189870;181990;363000;366182;140386;71986;1313414
2009;78;Yvelines;386231;197414;188817;372462;389611;168898;90358;1407560
2009;79;Deux-Sèvres;85208;43912;41296;83849;102715;54605;39962;366339
2009;80;Somme;143460;73312;70148;149287;153806;75534;47688;569775
2009;81;Tarn;84154;43044;41110;80036;104240;59756;45832;374018
2009;82;Tarn-et-Garonne;57455;29465;27990;54838;66469;35331;25198;239291
2009;83;Var;223610;115079;108531;220479;273094;177215;112905;1007303
2009;84;Vaucluse;133205;68346;64859;126465;149024;81570;49801;540065
2009;85;Vendée;149889;77046;72843;144641;169446;99273;63162;626411
2009;86;Vienne;99707;50388;49319;109691;114026;59944;42698;426066
2009;87;Haute-Vienne;79288;40173;39115;90184;103055;58539;43783;374849
2009;88;Vosges;90645;46545;44100;87076;108732;56704;37035;380192
2009;89;Yonne;81118;41684;39434;76463;95918;52902;36976;343377
2009;90;Territoire de Belfort;35608;18656;16952;37734;38727;18625;11767;142461
2009;91;Essonne;332875;170049;162826;331892;330275;139566;73396;1208004
2009;92;Hauts-de-Seine;392670;199820;192850;480385;405194;170313;113183;1561745
2009;93;Seine-Saint-Denis;438747;223120;215627;453825;397180;147939;78292;1515983
2009;94;Val-de-Marne;340211;173692;166519;389181;353514;146703;88928;1318537
2009;95;Val-d'Oise;335383;171265;164118;327597;321264;121064;63584;1168892
2009;971;Guadeloupe;120312;61891;58421;93918;114404;48820;24100;401554
2009;972;Martinique;108891;54973;53918;92318;116740;51695;26760;396404
2009;973;Guyane;99680;50651;49029;65773;45078;10478;3460;224469
2009;974;La Réunion;279585;142580;137005;227738;213165;69968;25908;816364
2010;01;Ain;159049;81392;77657;147795;168352;77592;44553;597341
2010;02;Aisne;140051;71724;68327;129269;150200;73874;47114;540508
2010;03;Allier;72071;37042;35029;70309;96593;59723;44212;342908
2010;04;Alpes-de-Haute-Provence;36154;18795;17359;32440;45668;28400;17487;160149
2010;05;Hautes-Alpes;31466;16078;15388;29056;39586;22438;14425;136971
2010;06;Alpes-Maritimes;235472;120818;114654;250738;288561;176434;127524;1078729
2010;07;Ardèche;72685;37412;35273;66679;88707;52282;34737;315090
2010;08;Ardennes;70956;36967;33989;66958;80373;39876;25087;283250
2010;09;Ariège;32874;16971;15903;31659;43373;25480;18652;152038
2010;10;Aube;74329;37789;36540;72391;82645;45039;28923;303327
2010;11;Aude;80382;41100;39282;76196;97305;60928;41656;356467
2010;12;Aveyron;57774;29926;27848;56288;76885;48369;37489;276805
2010;13;Bouches-du-Rhône;478766;243956;234810;503257;529405;282374;178216;1972018
2010;14;Calvados;169885;86611;83274;170840;184362;96108;61910;683105
2010;15;Cantal;28632;14591;14041;30260;43537;25867;19866;148162
2010;16;Charente;76841;39529;37312;75613;100827;57279;41017;351577
2010;17;Charente-Maritime;134587;69449;65138;132614;170053;111149;73920;622323
2010;18;Cher;68996;35319;33677;66377;87756;53045;35083;311257
2010;19;Corrèze;48920;25452;23468;50974;67901;42436;33320;243551
2010;21;Côte-d'Or;124339;63455;60884;136186;142081;73539;48213;524358
2010;22;Côtes-d'Armor;137885;71137;66748;124102;160262;100641;68751;591641
2010;23;Creuse;23189;11853;11336;22839;35263;22790;18948;123029
2010;24;Dordogne;84243;43245;40998;80703;117764;76881;54558;414149
2010;25;Doubs;133375;68436;64939;139827;138484;72758;43326;527770
2010;26;Drôme;120813;62475;58338;110856;133815;74214;45017;484715
2010;27;Eure;155308;79246;76062;143717;164212;78780;44526;586543
2010;28;Eure-et-Loir;110225;56657;53568;103810;118400;59010;37488;428933
2010;29;Finistère;212627;109455;103172;207870;247153;137439;92539;897628
2010;2A;Corse-du-Sud;29877;15541;14336;33762;41577;23846;14538;143600
2010;2B;Haute-Corse;34993;18187;16806;40716;46717;27398;16269;166093
2010;30;Gard;172491;88313;84178;160182;198317;110997;67713;709700
2010;31;Haute-Garonne;300828;154174;146654;366583;328845;152046;95339;1243641
2010;32;Gers;39142;20251;18891;36017;54676;33491;24833;188159
2010;33;Gironde;343990;175075;168915;385881;393121;197712;128541;1449245
2010;34;Hérault;244385;124229;120156;269093;273088;158459;99533;1044558
2010;35;Ille-et-Vilaine;256762;130363;126399;270231;256693;123441;81013;988140
2010;36;Indre;48644;24947;23697;46819;65298;40569;29846;231176
2010;37;Indre-et-Loire;142373;72410;69963;146359;159104;84908;57771;590515
2010;38;Isère;315659;162534;153125;317492;322916;157991;92316;1206374
2010;39;Jura;63528;32777;30751;57894;72562;40423;27127;261534
2010;40;Landes;85030;43719;41311;83015;108821;65091;42363;384320
2010;41;Loir-et-Cher;77264;39714;37550;70742;90935;52638;38500;330079
2010;42;Loire;183025;93776;89249;177526;196937;114020;77439;748947
2010;43;Haute-Loire;52757;27022;25735;47900;62769;35948;24632;224006
2010;44;Loire-Atlantique;331841;169923;161918;335966;341527;168126;104592;1282052
2010;45;Loiret;165757;84896;80861;164461;175736;91650;58501;656105
2010;46;Lot;35402;18090;17312;32866;49803;32978;23529;174578
2010;47;Lot-et-Garonne;72384;37510;34874;69274;91458;57188;40819;331123
2010;48;Lozère;16570;8717;7853;16557;22073;12953;8929;77082
2010;49;Maine-et-Loire;205810;104654;101156;199493;205367;103293;70847;784810
2010;50;Manche;116989;59828;57161;107820;138858;79021;56059;498747
2010;51;Marne;139823;71848;67975;150892;152970;75474;46148;565307
2010;52;Haute-Marne;41930;21630;20300;40675;52271;29439;19724;184039
2010;53;Mayenne;79500;40978;38522;70593;81721;42757;31766;306337
2010;54;Meurthe-et-Moselle;177426;90781;86645;198624;195329;97941;62887;732207
2010;55;Meuse;46281;23889;22392;46197;54687;27884;18874;193923
2010;56;Morbihan;170368;87798;82570;160457;199648;117279;73905;721657
2010;57;Moselle;244432;125578;118854;271073;303513;142689;83359;1045066
2010;58;Nièvre;44842;22876;21966;43725;61754;40288;28975;219584
2010;59;Nord;701224;359480;341744;711010;668621;309066;186849;2576770
2010;60;Oise;217644;111349;106295;209369;224844;98500;53238;803595
2010;61;Orne;69076;35628;33448;61891;80455;46906;33314;291642
2010;62;Pas-de-Calais;388227;199289;188938;370785;397395;188159;116821;1461387
2010;63;Puy-de-Dôme;142237;72103;70134;158843;175413;95759;60059;632311
2010;64;Pyrénées-Atlantiques;143249;73631;69618;149799;184168;103170;73129;653515
2010;65;Hautes-Pyrénées;47745;24809;22936;47603;65309;39631;29170;229458
2010;66;Pyrénées-Orientales;100594;51966;48628;97860;118850;77970;53269;448543
2010;67;Bas-Rhin;265297;135118;130179;295829;310329;141907;82543;1095905
2010;68;Haut-Rhin;182397;93257;89140;187513;217066;101485;61321;749782
2010;69;Rhône;446037;225608;220429;499605;428362;215462;135711;1725177
2010;70;Haute-Saône;58109;29950;28159;54298;67614;36932;22595;239548
2010;71;Saône-et-Loire;124238;64359;59879;118492;155643;92470;64820;555663
2010;72;Sarthe;141080;72030;69050;133128;152576;80560;56174;563518
2010;73;Savoie;101341;52333;49008;102611;116505;58785;35717;414959
2010;74;Haute-Savoie;187897;96766;91131;194703;208787;95706;50995;738088
2010;75;Paris;448052;224723;223329;786058;563890;278488;167345;2243833
2010;76;Seine-Maritime;316447;161621;154826;320121;337467;168824;107552;1250411
2010;77;Seine-et-Marne;374188;190751;183437;363953;366877;145942;73905;1324865
2010;78;Yvelines;384334;196421;187913;370137;388294;173531;92469;1408765
2010;79;Deux-Sèvres;86096;44365;41731;83096;102890;56032;41156;369270
2010;80;Somme;143641;73374;70267;147586;152926;78137;48451;570741
2010;81;Tarn;84109;43207;40902;79666;103978;61232;46394;375379
2010;82;Tarn-et-Garonne;58081;29772;28309;54702;66786;36211;25918;241698
2010;83;Var;221181;113614;107567;219514;271573;181022;114893;1008183
2010;84;Vaucluse;133191;68131;65060;125817;149548;84090;50459;543105
2010;85;Vendée;151968;78197;73771;144213;170676;102763;65158;634778
2010;86;Vienne;100341;50730;49611;108251;114094;61229;43278;427193
2010;87;Haute-Vienne;80690;40999;39691;88388;102211;60397;44505;376191
2010;88;Vosges;90205;46206;43999;85321;107712;58693;37793;379724
2010;89;Yonne;80409;41278;39131;75321;95261;54534;36985;342510
2010;90;Territoire de Belfort;35699;18673;17026;37785;38635;18955;11837;142911
2010;91;Essonne;333593;170002;163591;332407;329889;144200;75251;1215340
2010;92;Hauts-de-Seine;398200;202471;195729;477745;407383;174608;114554;1572490
2010;93;Seine-Saint-Denis;440761;224920;215841;455594;394477;150305;80911;1522048
2010;94;Val-de-Marne;342759;175959;166800;389117;354531;150001;91324;1327732
2010;95;Val-d'Oise;334258;170611;163647;327414;319910;124587;64992;1171161
2010;971;Guadeloupe;118775;60830;57945;92399;116204;50744;25233;403355
2010;972;Martinique;105693;53523;52170;89749;117963;53064;27704;394173
2010;973;Guyane;101277;51602;49675;66329;46582;11235;3617;229040
2010;974;La Réunion;278198;142322;135876;225439;218953;71741;26805;821136
2011;01;Ain;159835;81727;78108;148547;169154;80638;45653;603827
2011;02;Aisne;139855;71704;68151;127929;149525;76362;47631;541302
2011;03;Allier;72093;36782;35311;69610;95374;61184;44468;342729
2011;04;Alpes-de-Haute-Provence;36084;18762;17322;32111;45687;29231;17846;160959
2011;05;Hautes-Alpes;31787;16151;15636;29333;39926;22923;14636;138605
2011;06;Alpes-Maritimes;235488;121381;114107;250054;289044;179212;127446;1081244
2011;07;Ardèche;72947;37522;35425;66217;88790;54051;35272;317277
2011;08;Ardennes;70966;36868;34098;65875;79792;41100;25377;283110
2011;09;Ariège;32928;17053;15875;30923;43248;26315;18872;152286
2011;10;Aube;74078;37717;36361;71864;82045;46557;29453;303997
2011;11;Aude;80730;41155;39575;76088;97723;62925;42501;359967
2011;12;Aveyron;57504;29793;27711;55174;76354;49263;37518;275813
2011;13;Bouches-du-Rhône;478237;243553;234684;499827;527583;289038;181211;1975896
2011;14;Calvados;170045;87197;82848;169040;183279;99658;63240;685262
2011;15;Cantal;28371;14433;13938;29573;42910;26683;20040;147577
2011;16;Charente;76569;39538;37031;74959;100354;59040;41783;352705
2011;17;Charente-Maritime;133909;68833;65076;132323;169627;114740;75083;625682
2011;18;Cher;68574;35191;33383;65544;87622;54360;35594;311694
2011;19;Corrèze;48561;25058;23503;50282;67379;42992;33240;242454
2011;21;Côte-d'Or;123702;63392;60310;135832;140908;76452;49037;525931
2011;22;Côtes-d'Armor;137950;71125;66825;122566;160193;103705;69961;594375
2011;23;Creuse;23068;11968;11100;22088;35065;23317;19022;122560
2011;24;Dordogne;84168;43207;40961;79506;117215;79085;55194;415168
2011;25;Doubs;133780;68737;65043;138158;138376;74544;44245;529103
2011;26;Drôme;121055;62709;58346;110349;133952;76871;45766;487993
2011;27;Eure;155358;79557;75801;141837;163789;81878;45249;588111
2011;28;Eure-et-Loir;110360;56690;53670;102981;118013;61010;38052;430416
2011;29;Finistère;211675;108960;102715;206094;247128;141359;93614;899870
2011;2A;Corse-du-Sud;30037;15593;14444;33995;41809;24928;15077;145846
2011;2B;Haute-Corse;35362;18373;16989;41187;47134;28384;16573;168640
2011;30;Gard;172774;88383;84391;160503;199907;115235;69938;718357
2011;31;Haute-Garonne;305995;156547;149448;368408;331806;156767;97250;1260226
2011;32;Gers;39254;20272;18982;35740;54528;34339;25032;188893
2011;33;Gironde;347074;176411;170663;385885;394653;205380;130670;1463662
2011;34;Hérault;251318;127396;123922;269053;276242;164452;100971;1062036
2011;35;Ille-et-Vilaine;259312;131436;127876;269172;258917;126862;82176;996439
2011;36;Indre;48019;24655;23364;46097;64623;41211;30225;230175
2011;37;Indre-et-Loire;143192;72708;70484;144883;159037;87284;59287;593683
2011;38;Isère;315594;162667;152927;316138;324686;163863;94931;1215212
2011;39;Jura;62755;32373;30382;57279;72357;41235;27668;261294
2011;40;Landes;85512;44023;41489;82546;109730;67316;42825;387929
2011;41;Loir-et-Cher;76637;39360;37277;70346;90544;54618;39135;331280
2011;42;Loire;183136;93908;89228;175539;195826;115653;78899;749053
2011;43;Haute-Loire;52790;27068;25722;47468;62725;37155;24769;224907
2011;44;Loire-Atlantique;335130;171600;163530;336630;344144;174036;106424;1296364
2011;45;Loiret;167847;86103;81744;162598;175640;94379;59123;659587
2011;46;Lot;34962;17916;17046;32510;49462;33929;23891;174754
2011;47;Lot-et-Garonne;71970;37134;34836;68529;90396;58444;41527;330866
2011;48;Lozère;16598;8683;7915;16342;21962;13297;8957;77156
2011;49;Maine-et-Loire;208070;105713;102357;197889;205403;106435;72546;790343
2011;50;Manche;115901;59272;56629;106818;138726;81031;57055;499531
2011;51;Marne;139217;71453;67764;149938;152057;78410;46949;566571
2011;52;Haute-Marne;40637;20945;19692;40360;51274;29990;20114;182375
2011;53;Mayenne;79757;41006;38751;69053;81708;44025;32488;307031
2011;54;Meurthe-et-Moselle;177687;90751;86936;196639;194442;100842;63514;733124
2011;55;Meuse;46564;24184;22380;44812;54228;28759;19194;193557
2011;56;Morbihan;171471;88458;83013;159272;199943;120968;75429;727083
2011;57;Moselle;242164;124244;117920;268309;302555;147092;85026;1045146
2011;58;Nièvre;44386;22669;21717;42696;60576;41418;29265;218341
2011;59;Nord;696905;357292;339613;707214;666868;318711;189510;2579208
2011;60;Oise;216697;110893;105804;207388;224425;102523;54609;805642
2011;61;Orne;68568;35312;33256;60343;79761;48199;34020;290891
2011;62;Pas-de-Calais;388632;199557;189075;366805;395345;194534;117491;1462807
2011;63;Puy-de-Dôme;141455;71667;69788;159127;174476;98808;61603;635469
2011;64;Pyrénées-Atlantiques;143396;73674;69722;148677;184036;105840;74659;656608
2011;65;Hautes-Pyrénées;47552;24714;22838;46892;65133;40616;29035;229228
2011;66;Pyrénées-Orientales;101560;52592;48968;97543;119199;79932;54296;452530
2011;67;Bas-Rhin;265227;135810;129417;294438;308983;145891;84730;1099269
2011;68;Haut-Rhin;182885;93644;89241;185467;217498;104958;62248;753056
2011;69;Rhône;449811;228127;221684;504664;431355;220363;138043;1744236
2011;70;Haute-Saône;57947;29945;28002;53130;67689;38066;22863;239695
2011;71;Saône-et-Loire;123508;63883;59625;117246;154716;95195;65334;555999
2011;72;Sarthe;142165;72544;69621;131359;152036;82890;57268;565718
2011;73;Savoie;102134;52728;49406;102308;117466;60553;36488;418949
2011;74;Haute-Savoie;188977;97142;91835;197230;209664;98510;52613;746994
2011;75;Paris;447812;224500;223312;784133;562972;286875;168183;2249975
2011;76;Seine-Maritime;314421;160679;153742;317240;336099;173977;109545;1251282
2011;77;Seine-et-Marne;376178;191877;184301;362830;370179;152918;76322;1338427
2011;78;Yvelines;386517;197789;188728;365626;388363;178294;94835;1413635
2011;79;Deux-Sèvres;86639;44623;42016;81175;103416;58031;41678;370939
2011;80;Somme;142954;73161;69793;146461;152317;80618;48861;571211
2011;81;Tarn;84129;43253;40876;78743;104620;62567;47616;377675
2011;82;Tarn-et-Garonne;58805;30238;28567;54727;67351;37521;26141;244545
2011;83;Var;220479;113064;107415;219571;271758;184870;116057;1012735
2011;84;Vaucluse;133495;68331;65164;125335;149399;86520;51881;546630
2011;85;Vendée;153020;78712;74308;144087;171255;106117;67178;641657
2011;86;Vienne;101075;51384;49691;106697;113608;63106;43961;428447
2011;87;Haute-Vienne;81065;41358;39707;87625;101515;61266;44587;376058
2011;88;Vosges;89146;45851;43295;84300;106872;60134;38378;378830
2011;89;Yonne;80427;41329;39098;73963;94464;56044;37565;342463
2011;90;Territoire de Belfort;35518;18371;17147;37751;38396;19634;12049;143348
2011;91;Essonne;336098;171897;164201;332340;330786;148238;77729;1225191
2011;92;Hauts-de-Seine;400708;204188;196520;476694;409798;178684;115744;1581628
2011;93;Seine-Saint-Denis;442374;225580;216794;455508;394616;155112;82318;1529928
2011;94;Val-de-Marne;344272;175843;168429;388804;354333;154017;92276;1333702
2011;95;Val-d'Oise;337058;172047;165011;327104;320176;129561;66466;1180365
2011;971;Guadeloupe;116547;59401;57146;90459;117860;53233;26536;404635
2011;972;Martinique;102313;51780;50533;86340;119298;54668;29672;392291
2011;973;Guyane;104063;53214;50849;68394;48889;12340;3863;237549
2011;974;La Réunion;274939;140564;134375;225332;223635;75847;28828;828581
2012;01;Ain;161231;82465;78766;148637;171898;83266;47159;612191
2012;02;Aisne;138748;71079;67669;126112;148847;78639;48542;540888
2012;03;Allier;71637;36591;35046;68776;95067;62337;45094;342911
2012;04;Alpes-de-Haute-Provence;35587;18477;17110;32118;45580;29857;18099;161241
2012;05;Hautes-Alpes;31430;15986;15444;29440;40067;23604;15013;139554
2012;06;Alpes-Maritimes;234149;120911;113238;249687;288804;181560;127814;1082014
2012;07;Ardèche;72616;37239;35377;65410;89072;55689;35620;318407
2012;08;Ardennes;70037;36256;33781;64667;79596;42568;25910;282778
2012;09;Ariège;32592;16856;15736;30302;43255;26887;19330;152366
2012;10;Aube;73995;37752;36243;71578;81844;47998;30191;305606
2012;11;Aude;81334;41589;39745;74680;98711;64792;42822;362339
2012;12;Aveyron;57585;29877;27708;54458;76319;49744;38123;276229
2012;13;Bouches-du-Rhône;478927;244069;234858;498518;529364;295474;182501;1984784
2012;14;Calvados;168396;86383;82013;167954;183651;103729;64124;687854
2012;15;Cantal;28470;14524;13946;28775;42490;27301;20379;147415
2012;16;Charente;75943;39110;36833;74343;100149;60841;42381;353657
2012;17;Charente-Maritime;134618;69012;65606;129593;170186;118062;76274;628733
2012;18;Cher;67739;34901;32838;65051;87347;55508;36252;311897
2012;19;Corrèze;48200;24781;23419;49203;66949;43611;33284;241247
2012;21;Côte-d'Or;122959;62971;59988;135552;141062;78626;49204;527403
2012;22;Côtes-d'Armor;137258;70858;66400;120838;160162;106072;71201;595531
2012;23;Creuse;22742;11825;10917;21330;34783;23716;18946;121517
2012;24;Dordogne;83769;43035;40734;78557;116986;80924;56148;416384
2012;25;Doubs;133580;68138;65442;137499;138770;76219;44994;531062
2012;26;Drôme;121491;62896;58595;109703;134840;78952;46348;491334
2012;27;Eure;155634;79880;75754;140269;164278;84965;46470;591616
2012;28;Eure-et-Loir;110620;56702;53918;101399;118433;63014;38641;432107
2012;29;Finistère;209504;107693;101811;204118;246895;145129;95647;901293
2012;2A;Corse-du-Sud;29696;15457;14239;33832;41530;25154;15217;145429
2012;2B;Haute-Corse;35684;18521;17163;41868;47389;28796;17091;170828
2012;30;Gard;172056;88015;84041;160553;201680;119676;71653;725618
2012;31;Haute-Garonne;310041;158472;151569;372388;336644;161052;99224;1279349
2012;32;Gers;39289;20168;19121;35312;54386;35014;25529;189530
2012;33;Gironde;350012;177814;172198;387482;400336;212624;133258;1483712
2012;34;Hérault;252150;128332;123818;272461;279874;170574;102568;1077627
2012;35;Ille-et-Vilaine;263760;133846;129914;267805;261778;130534;84024;1007901
2012;36;Indre;47792;24582;23210;44580;63964;41847;30509;228692
2012;37;Indre-et-Loire;143353;72549;70804;144215;159141;89784;60444;596937
2012;38;Isère;318755;164459;154296;313240;328618;167960;96420;1224993
2012;39;Jura;62515;32152;30363;56107;72500;42083;27727;260932
2012;40;Landes;86776;44804;41972;82493;110889;69030;43696;392884
2012;41;Loir-et-Cher;76273;39126;37147;69468;90574;56147;39194;331656
2012;42;Loire;184140;94338;89802;174287;197103;118059;80174;753763
2012;43;Haute-Loire;52655;26975;25680;46904;63200;37945;24982;225686
2012;44;Loire-Atlantique;338331;173331;165000;337190;348472;180576;108752;1313321
2012;45;Loiret;167598;86260;81338;161077;176078;97226;60318;662297
2012;46;Lot;34475;17630;16845;31751;49269;34607;24244;174346
2012;47;Lot-et-Garonne;72020;37062;34958;68070;90471;59504;42054;332119
2012;48;Lozère;16365;8489;7876;15991;21887;13586;9060;76889
2012;49;Maine-et-Loire;210411;106601;103810;195867;206614;109537;73128;795557
2012;50;Manche;115749;59210;56539;104800;138453;82464;57874;499340
2012;51;Marne;139785;71407;68378;147988;152065;81158;47754;568750
2012;52;Haute-Marne;40483;20871;19612;39959;50962;30560;20172;182136
2012;53;Mayenne;79679;40836;38843;68336;81945;44852;32641;307453
2012;54;Meurthe-et-Moselle;176558;90026;86532;194317;194866;103237;64288;733266
2012;55;Meuse;45813;23800;22013;43957;53879;29686;19465;192800
2012;56;Morbihan;171475;88198;83277;157299;201248;124115;78235;732372
2012;57;Moselle;240933;123666;117267;264213;302790;150653;87879;1046468
2012;58;Nièvre;43635;22472;21163;41744;59695;42260;29452;216786
2012;59;Nord;695141;355877;339264;701190;668398;329371;193028;2587128
2012;60;Oise;216640;110901;105739;206017;225718;106105;55820;810300
2012;61;Orne;67702;34725;32977;59129;79123;49305;34756;290015
2012;62;Pas-de-Calais;386721;198791;187930;361469;394639;200483;120316;1463628
2012;63;Puy-de-Dôme;140891;71315;69576;158147;174641;101736;62677;638092
2012;64;Pyrénées-Atlantiques;143323;73611;69712;147961;185078;108687;75822;660871
2012;65;Hautes-Pyrénées;47633;24767;22866;45529;64529;41333;29830;228854
2012;66;Pyrénées-Orientales;103161;53411;49750;97285;120588;81679;55080;457793
2012;67;Bas-Rhin;265092;135668;129424;291503;311197;150271;86604;1104667
2012;68;Haut-Rhin;181956;92991;88965;183645;217985;107807;63809;755202
2012;69;Rhône;454872;230590;224282;508864;435053;224828;139249;1762866
2012;70;Haute-Saône;57386;29708;27678;52322;67447;39264;23331;239750
2012;71;Saône-et-Loire;122829;63593;59236;114476;154531;97359;65844;555039
2012;72;Sarthe;142176;72719;69457;129571;152595;84721;58319;567382
2012;73;Savoie;101541;52654;48887;101591;118186;62294;37493;421105
2012;74;Haute-Savoie;190609;98063;92546;198655;212159;101365;53713;756501
2012;75;Paris;445889;223689;222200;774355;563400;290090;166887;2240621
2012;76;Seine-Maritime;313758;160279;153479;314075;336614;178925;110559;1253931
2012;77;Seine-et-Marne;380313;194001;186312;362061;374431;158424;78717;1353946
2012;78;Yvelines;383459;196000;187459;362865;388468;181724;95840;1412356
2012;79;Deux-Sèvres;86479;44478;42001;80719;103430;59079;41876;371583
2012;80;Somme;141516;72352;69164;144268;152346;82826;50198;571154
2012;81;Tarn;84491;43433;41058;77818;104892;63919;47827;378947
2012;82;Tarn-et-Garonne;59538;30659;28879;54310;67885;38924;26314;246971
2012;83;Var;221871;114053;107818;218971;274648;188495;117684;1021669
2012;84;Vaucluse;132398;67896;64502;123303;149394;88434;52785;546314
2012;85;Vendée;154468;79191;75277;143198;173070;109777;68388;648901
2012;86;Vienne;100764;51123;49641;106465;113655;64788;44346;430018
2012;87;Haute-Vienne;80953;41228;39725;86411;101282;62673;44550;375869
2012;88;Vosges;88099;45325;42774;81861;106374;61811;39137;377282
2012;89;Yonne;80106;40963;39143;72267;94019;57320;38190;341902
2012;90;Territoire de Belfort;35258;18200;17058;37599;38487;20313;12283;143940
2012;91;Essonne;340015;173529;166486;333822;333454;151062;79154;1237507
2012;92;Hauts-de-Seine;402429;204961;197468;474213;413966;181445;114381;1586434
2012;93;Seine-Saint-Denis;444287;226485;217802;455451;396771;159399;82818;1538726
2012;94;Val-de-Marne;346680;176673;170007;388464;356232;157609;92846;1341831
2012;95;Val-d'Oise;338164;173116;165048;328591;319658;133024;67644;1187081
2012;971;Guadeloupe;114445;58237;56208;87738;119147;54639;27345;403314
2012;972;Martinique;99846;50482;49364;82615;119413;55870;30620;388364
2012;973;Guyane;103030;52514;50516;70347;49394;13001;3876;239648
2012;974;La Réunion;272136;139210;132926;222890;228925;79157;30836;833944
2013;01;Ain;162893;83233;79660;148079;174646;85940;47939;619497
2013;02;Aisne;137285;70337;66948;124418;147874;81501;48989;540067
2013;03;Allier;72278;37024;35254;67534;94572;64040;45007;343431
2013;04;Alpes-de-Haute-Provence;35476;18349;17127;31676;45603;30477;18684;161916
2013;05;Hautes-Alpes;31582;16080;15502;28733;39917;24147;14900;139279
2013;06;Alpes-Maritimes;231239;119223;112016;247206;289801;183665;128860;1080771
2013;07;Ardèche;73300;37611;35689;64538;89692;57272;35577;320379
2013;08;Ardennes;68870;35508;33362;63547;78997;43429;26064;280907
2013;09;Ariège;32496;16756;15740;30138;42934;27765;19351;152684
2013;10;Aube;74713;38196;36517;70962;81598;48941;30367;306581
2013;11;Aude;81597;41620;39977;73295;99629;67119;43237;364877
2013;12;Aveyron;57775;29983;27792;53653;76572;50938;38802;277740
2013;13;Bouches-du-Rhône;482160;246514;235646;494866;532027;301476;182648;1993177
2013;14;Calvados;170642;87403;83239;163213;183636;107400;65054;689945
2013;15;Cantal;28260;14356;13904;28243;42160;27886;20486;147035
2013;16;Charente;75482;38966;36516;73381;99879;62410;42330;353482
2013;17;Charente-Maritime;134450;69241;65209;127989;171169;122330;77479;633417
2013;18;Cher;67658;34928;32730;63946;86624;56797;36625;311650
2013;19;Corrèze;49236;25708;23528;47582;66189;44498;33276;240781
2013;21;Côte-d'Or;124510;63633;60877;133085;141416;80968;49782;529761
2013;22;Côtes-d'Armor;138176;71126;67050;117944;160136;108497;72332;597085
2013;23;Creuse;22630;11749;10881;20984;34351;24075;18832;120872
2013;24;Dordogne;84014;43146;40868;76768;117008;82833;56286;416909
2013;25;Doubs;132921;67822;65099;137327;139020;78131;45921;533320
2013;26;Drôme;121359;62748;58611;109520;135343;80756;47734;494712
2013;27;Eure;156379;80297;76082;138471;165148;87722;47323;595043
2013;28;Eure-et-Loir;110566;56683;53883;99467;118639;65350;38945;432967
2013;29;Finistère;209373;107593;101780;202019;247677;148327;96525;903921
2013;2A;Corse-du-Sud;30654;15969;14685;34746;42694;25638;15502;149234
2013;2B;Haute-Corse;34933;18035;16898;41325;47669;29524;17523;170974
2013;30;Gard;174095;89220;84875;158448;202867;124549;73242;733201
2013;31;Haute-Garonne;313534;160260;153274;376532;340901;166816;100779;1298562
2013;32;Gers;39398;20180;19218;34661;54606;35956;25655;190276
2013;33;Gironde;355792;181316;174476;389214;406258;220305;133948;1505517
2013;34;Hérault;253864;129675;124189;274623;283816;176159;103869;1092331
2013;35;Ille-et-Vilaine;265398;134540;130858;269844;264210;134597;85874;1019923
2013;36;Indre;47479;24466;23013;43367;63638;42897;30710;228091
2013;37;Indre-et-Loire;144148;73030;71118;143031;159683;92436;60954;600252
2013;38;Isère;322307;166467;155840;310673;332070;172676;97661;1235387
2013;39;Jura;62095;31859;30236;54878;72437;43186;27906;260502
2013;40;Landes;87286;44842;42444;81849;112322;71709;44060;397226
2013;41;Loir-et-Cher;76796;39459;37337;68032;90516;57297;39360;332001
2013;42;Loire;184106;94472;89634;173647;197002;121065;80895;756715
2013;43;Haute-Loire;52526;26993;25533;46050;63415;39026;25186;226203
2013;44;Loire-Atlantique;343755;175853;167902;335690;351387;186995;110793;1328620
2013;45;Loiret;168163;86365;81798;159827;176817;99725;61055;665587
2013;46;Lot;34080;17434;16646;31226;48838;35281;24333;173758
2013;47;Lot-et-Garonne;72432;37295;35137;67155;89955;61345;42293;333180
2013;48;Lozère;16147;8292;7855;15835;21652;13769;9204;76607
2013;49;Maine-et-Loire;210695;107072;103623;194555;207340;113498;74103;800191
2013;50;Manche;114633;58737;55896;103850;138072;84509;58855;499919
2013;51;Marne;139984;71490;68494;146481;151688;83596;48250;569999
2013;52;Haute-Marne;39958;20525;19433;39172;50566;31398;20427;181521
2013;53;Mayenne;79179;40591;38588;67304;81714;45852;33451;307500
2013;54;Meurthe-et-Moselle;175202;89609;85593;191176;193843;105837;64946;731004
2013;55;Meuse;45078;23369;21709;43344;53521;30404;19747;192094
2013;56;Morbihan;171943;88496;83447;155933;202318;127513;80071;737778
2013;57;Moselle;240646;123952;116694;260154;302037;154359;89677;1046873
2013;58;Nièvre;43094;22308;20786;40749;58954;43026;29398;215221
2013;59;Nord;697873;357031;340842;696143;669535;338239;193746;2595536
2013;60;Oise;218564;111554;107010;203600;226929;109414;56893;815400
2013;61;Orne;66731;34384;32347;58168;78562;50516;34871;288848
2013;62;Pas-de-Calais;385698;197846;187852;356697;394261;206880;121669;1465205
2013;63;Puy-de-Dôme;141286;71556;69730;157509;175119;104342;62743;640999
2013;64;Pyrénées-Atlantiques;143398;73657;69741;146909;185764;111197;76789;664057
2013;65;Hautes-Pyrénées;47360;24527;22833;44777;64318;41996;30417;228868
2013;66;Pyrénées-Orientales;104104;53830;50274;96568;121474;84740;55819;462705
2013;67;Bas-Rhin;264320;135256;129064;289428;312050;154977;88685;1109460
2013;68;Haut-Rhin;182302;93416;88886;182280;217910;111373;64858;758723
2013;69;Rhône;460410;233945;226465;509968;439200;228876;141391;1779845
2013;70;Haute-Saône;56663;29354;27309;51245;67223;40286;23539;238956
2013;71;Saône-et-Loire;123272;63810;59462;112738;153715;99939;66558;556222
2013;72;Sarthe;142936;73156;69780;127441;152512;87143;59003;569035
2013;73;Savoie;101214;52231;48983;100997;119013;64238;38253;423715
2013;74;Haute-Savoie;192744;99023;93721;200824;215631;105159;55319;769677
2013;75;Paris;440008;220759;219249;765369;561425;295809;167010;2229621
2013;76;Seine-Maritime;312888;159840;153048;310251;335504;184936;111030;1254609
2013;77;Seine-et-Marne;381849;194795;187054;360383;378196;164513;80259;1365200
2013;78;Yvelines;384249;196511;187738;358937;390393;186493;98412;1418484
2013;79;Deux-Sèvres;86746;44738;42008;78835;103387;60377;42287;371632
2013;80;Somme;142054;72669;69385;141889;152213;85232;50287;571675
2013;81;Tarn;85889;44056;41833;77188;105241;65590;48019;381927
2013;82;Tarn-et-Garonne;60323;30902;29421;54340;68545;40106;27028;250342
2013;83;Var;222137;114033;108104;218284;275969;192734;119459;1028583
2013;84;Vaucluse;133298;68221;65077;122773;150125;90789;52964;549949
2013;85;Vendée;156156;79967;76189;142034;173935;113619;69762;655506
2013;86;Vienne;101042;51360;49682;104782;113374;66727;45323;431248
2013;87;Haute-Vienne;80873;41056;39817;85248;100763;64260;44712;375856
2013;88;Vosges;86703;44574;42129;80053;105479;63236;39755;375226
2013;89;Yonne;79871;40981;38890;71060;93435;59007;38110;341483
2013;90;Territoire de Belfort;36169;18966;17203;36841;38225;20766;12317;144318
2013;91;Essonne;345164;176380;168784;332860;338615;155548;81744;1253931
2013;92;Hauts-de-Seine;402877;205509;197368;470510;416443;186493;115080;1591403
2013;93;Seine-Saint-Denis;448779;229166;219613;458311;399722;162712;82958;1552482
2013;94;Val-de-Marne;349777;178489;171288;388464;360088;161645;94031;1354005
2013;95;Val-d'Oise;340649;174356;166293;328403;319829;136976;68824;1194681
2013;971;Guadeloupe;112120;56808;55312;85045;120211;56872;27871;402119
2013;972;Martinique;97316;49379;47937;79330;119987;57377;31541;385551
2013;973;Guyane;104821;53474;51347;70319;51117;13794;4067;244118
2013;974;La Réunion;268728;137391;131337;219896;231825;82397;32257;835103
2014;01;Ain;164484;84377;80107;147102;176814;89136;48591;626127
2014;02;Aisne;136959;70128;66831;121899;147514;84124;49287;539783
2014;03;Allier;72070;36879;35191;66250;94215;65199;45328;343062
2014;04;Alpes-de-Haute-Provence;35189;18208;16981;30862;45392;30954;19191;161588
2014;05;Hautes-Alpes;31669;16094;15575;28358;39918;24716;15222;139883
2014;06;Alpes-Maritimes;230183;118513;111670;243968;291425;187265;130471;1083312
2014;07;Ardèche;73361;37601;35760;63190;90251;59188;36391;322381
2014;08;Ardennes;68069;34993;33076;62098;78565;44286;26697;279715
2014;09;Ariège;32276;16764;15512;29888;42750;28330;19330;152574
2014;10;Aube;75263;38557;36706;70325;81466;50049;30991;308094
2014;11;Aude;80902;41158;39744;71925;99696;69319;43636;365478
2014;12;Aveyron;58275;30386;27889;52535;76825;52079;38930;278644
2014;13;Bouches-du-Rhône;484052;247519;236533;491144;535380;309695;185798;2006069
2014;14;Calvados;171018;87796;83222;160649;183269;110607;66127;691670
2014;15;Cantal;28126;14236;13890;27739;41829;28411;20513;146618
2014;16;Charente;75967;39415;36552;71901;99376;64158;42451;353853
2014;17;Charente-Maritime;135731;70240;65491;124968;171208;126622;78560;637089
2014;18;Cher;67629;34994;32635;62532;86061;57298;36750;310270
2014;19;Corrèze;49378;25647;23731;47143;66094;45398;33327;241340
2014;21;Côte-d'Or;125781;64263;61518;130471;141401;83400;50327;531380
2014;22;Côtes-d'Armor;137908;70989;66919;115277;159935;110806;73471;597397
2014;23;Creuse;22433;11651;10782;20803;34044;24484;18817;120581
2014;24;Dordogne;83104;42663;40441;75494;116329;84724;56699;416350
2014;25;Doubs;132773;67810;64963;136142;139550;79277;46968;534710
2014;26;Drôme;122531;63359;59172;109129;136119;82973;48407;499159
2014;27;Eure;157323;80844;76479;137010;165390;90524;48100;598347
2014;28;Eure-et-Loir;110483;56678;53805;97929;118490;67026;39834;433762
2014;29;Finistère;210867;108386;102481;197098;248474;151881;97535;905855
2014;2A;Corse-du-Sud;31057;16036;15021;34988;42985;26568;16054;151652
2014;2B;Haute-Corse;34859;18011;16848;41686;48011;30299;17705;172560
2014;30;Gard;175017;89822;85195;156957;202452;127577;74026;736029
2014;31;Haute-Garonne;318686;162623;156063;381587;345057;170903;101435;1317668
2014;32;Gers;39568;20343;19225;34083;54392;36802;25780;190625
2014;33;Gironde;362569;184692;177877;390423;411162;226815;135047;1526016
2014;34;Hérault;256818;131168;125650;276648;286473;181709;105750;1107398
2014;35;Ille-et-Vilaine;267202;135937;131265;269946;268028;139110;87954;1032240
2014;36;Indre;46964;24072;22892;41788;62856;43762;30805;226175
2014;37;Indre-et-Loire;144985;73329;71656;142601;160014;94638;61686;603924
2014;38;Isère;323315;166409;156906;308146;334317;177983;99836;1243597
2014;39;Jura;61569;31649;29920;54336;72179;44172;28425;260681
2014;40;Landes;87415;45052;42363;80910;113021;73971;45160;400477
2014;41;Loir-et-Cher;77681;39909;37772;67209;90596;58310;39771;333567
2014;42;Loire;185010;94841;90169;170330;196315;123885;81765;757305
2014;43;Haute-Loire;52321;26993;25328;45451;63410;39932;25451;226565
2014;44;Loire-Atlantique;348214;178008;170206;338158;355472;192224;112524;1346592
2014;45;Loiret;169552;87062;82490;158431;177709;102301;61744;669737
2014;46;Lot;34555;17607;16948;30336;48710;35813;24234;173648
2014;47;Lot-et-Garonne;72336;37220;35116;66074;89936;62531;42357;333234
2014;48;Lozère;16175;8319;7856;15487;21542;13878;9278;76360
2014;49;Maine-et-Loire;212297;107876;104421;192612;208951;116434;75594;805888
2014;50;Manche;115031;58759;56272;101953;137467;86267;59240;499958
2014;51;Marne;141150;72405;68745;144812;151346;85090;48419;570817
2014;52;Haute-Marne;39465;20168;19297;38229;50220;32081;20678;180673
2014;53;Mayenne;79166;40628;38538;66204;81487;47066;33548;307471
2014;54;Meurthe-et-Moselle;175452;89958;85494;189979;193119;107655;65948;732153
2014;55;Meuse;44915;23201;21714;42162;53196;31302;19955;191530
2014;56;Morbihan;172999;89181;83818;152287;203271;131547;80947;741051
2014;57;Moselle;239345;123090;116255;255801;300058;158349;91601;1045154
2014;58;Nièvre;42718;22248;20470;39696;57692;43741;29722;213569
2014;59;Nord;700014;358567;341447;692167;670657;346055;194579;2603472
2014;60;Oise;219768;112092;107676;200622;227870;112879;57541;818680
2014;61;Orne;65957;34005;31952;56794;78025;51536;35438;287750
2014;62;Pas-de-Calais;389140;200514;188626;353803;394209;212726;122711;1472589
2014;63;Puy-de-Dôme;144664;73444;71220;153935;175111;107018;63488;644216
2014;64;Pyrénées-Atlantiques;145346;74732;70614;144449;186296;113667;77491;667249
2014;65;Hautes-Pyrénées;47595;24544;23051;43926;64057;42812;30560;228950
2014;66;Pyrénées-Orientales;105364;54200;51164;95267;122744;86782;56170;466327
2014;67;Bas-Rhin;262352;133855;128497;289335;311827;158692;90609;1112815
2014;68;Haut-Rhin;182695;93422;89273;179595;217501;114765;65578;760134
2014;69;Rhône;465635;236524;229111;513199;444300;233941;144810;1801885
2014;70;Haute-Saône;56610;29470;27140;49717;67348;41162;23510;238347
2014;71;Saône-et-Loire;122550;63091;59459;110642;153121;102225;67250;555788
2014;72;Sarthe;142393;72774;69619;125508;151849;89393;59617;568760
2014;73;Savoie;101142;52084;49058;100528;119986;66126;39142;426924
2014;74;Haute-Savoie;196276;100773;95503;202862;219249;108393;56347;783127
2014;75;Paris;437621;218992;218629;752452;561412;301954;167006;2220445
2014;76;Seine-Maritime;314007;160143;153864;306674;335497;190121;111621;1257920
2014;77;Seine-et-Marne;386092;197230;188862;359507;381829;169141;81277;1377846
2014;78;Yvelines;383399;196157;187242;354128;392186;190424;101533;1421670
2014;79;Deux-Sèvres;87704;45173;42531;77731;103750;61702;42666;373553
2014;80;Somme;142589;72769;69820;139558;152114;87066;50305;571632
2014;81;Tarn;86691;44201;42490;76543;105254;67320;48666;384474
2014;82;Tarn-et-Garonne;61196;31412;29784;53678;69209;41493;27002;252578
2014;83;Var;222000;114009;107991;216505;278646;198657;122404;1038212
2014;84;Vaucluse;134072;68626;65446;122429;150996;92952;53925;554374
2014;85;Vendée;158934;81500;77434;139020;175479;116984;71705;662122
2014;86;Vienne;101561;51643;49918;103644;113619;68627;45752;433203
2014;87;Haute-Vienne;81437;41439;39998;83379;100707;65911;44765;376199
2014;88;Vosges;85781;43976;41805;77639;104836;64907;40397;373560
2014;89;Yonne;79733;41009;38724;70006;93148;60406;38521;341814
2014;90;Territoire de Belfort;35909;18879;17030;36352;38269;21176;12628;144334
2014;91;Essonne;347311;177158;170153;335572;342541;158576;84228;1268228
2014;92;Hauts-de-Seine;402906;204957;197949;467730;422731;189605;114798;1597770
2014;93;Seine-Saint-Denis;454222;232034;222188;461230;404335;168177;83064;1571028
2014;94;Val-de-Marne;352006;179899;172107;387735;364493;164847;95958;1365039
2014;95;Val-d'Oise;343826;175288;168538;328219;321897;141849;69748;1205539
2014;971;Guadeloupe;110780;56294;54486;82354;120096;58560;28396;400186
2014;972;Martinique;94952;48444;46508;76841;120206;59331;32581;383911
2014;973;Guyane;108615;55089;53526;71609;53435;14583;4096;252338
2014;974;La Réunion;269805;138101;131704;217785;234599;86575;34003;842767
2014;976;Mayotte;121865;60648;61217;60601;31923;7231;2093;223713
2015;01;Ain;166118;85266;80852;146852;177635;91661;49611;631877
2015;02;Aisne;137497;70332;67165;119753;145955;86426;49028;538659
2015;03;Allier;71332;36471;34861;65411;93080;66574;45216;341613
2015;04;Alpes-de-Haute-Provence;35000;18201;16799;30339;45080;31936;19444;161799
2015;05;Hautes-Alpes;31564;16106;15458;28640;39790;25392;15530;140916
2015;06;Alpes-Maritimes;231356;118951;112405;242791;288705;188738;130850;1082440
2015;07;Ardèche;73239;37375;35864;63166;90399;60703;36702;324209
2015;08;Ardennes;66982;34442;32540;60496;77520;45632;27122;277752
2015;09;Ariège;32248;16659;15589;29332;42558;29118;19243;152499
2015;10;Aube;75162;38643;36519;70146;81293;51274;31181;309056
2015;11;Aude;80757;41203;39554;71724;99213;71464;43799;366957
2015;12;Aveyron;58034;30299;27735;52414;76419;53324;38978;279169
2015;13;Bouches-du-Rhône;484567;247589;236978;491927;534461;317089;188578;2016622
2015;14;Calvados;169622;86804;82818;160023;181998;114476;67460;693579
2015;15;Cantal;27747;14111;13636;27292;41462;29147;20571;146219
2015;16;Charente;75945;39520;36425;70603;98596;65779;42690;353613
2015;17;Charente-Maritime;135463;69773;65690;123557;170498;130497;79923;639938
2015;18;Cher;67326;34718;32608;61171;85130;58436;36929;308992
2015;19;Corrèze;49310;25542;23768;46755;66135;46494;33177;241871
2015;21;Côte-d'Or;126041;64081;61960;129839;140769;85432;51066;533147
2015;22;Côtes-d'Armor;137905;71040;66865;112936;159400;113639;74477;598357
2015;23;Creuse;22121;11432;10689;20543;33647;25234;18820;120365
2015;24;Dordogne;82689;42454;40235;73881;114964;86751;57132;415417
2015;25;Doubs;134761;68881;65880;134108;138754;81319;48017;536959
2015;26;Drôme;123953;63993;59960;109257;137098;85175;49154;504637
2015;27;Eure;157818;81165;76653;135750;165617;93660;49103;601948
2015;28;Eure-et-Loir;110486;56592;53894;96493;118183;68494;40379;434035
2015;29;Finistère;211109;108534;102575;194570;247538;155652;98927;907796
2015;2A;Corse-du-Sud;30619;15822;14797;34762;43094;27584;16671;152730
2015;2B;Haute-Corse;37104;19123;17981;40262;48034;31030;18123;174553
2015;30;Gard;174879;89718;85161;155914;201343;131250;74803;738189
2015;31;Haute-Garonne;323586;165084;158502;385258;347995;175488;102776;1335103
2015;32;Gers;39309;20305;19004;33852;54050;37794;25927;190932
2015;33;Gironde;367510;187013;180497;396082;414988;234069;135829;1548478
2015;34;Hérault;258561;132024;126537;279177;286806;187772;107874;1120190
2015;35;Ille-et-Vilaine;270738;138121;132617;269907;270472;142827;88940;1042884
2015;36;Indre;46349;23804;22545;40754;61867;44335;30895;224200
2015;37;Indre-et-Loire;145223;73234;71989;140386;159446;97172;62739;604966
2015;38;Isère;325529;167038;158491;305747;335131;182769;101884;1251060
2015;39;Jura;61670;31768;29902;53085;71930;45390;28512;260587
2015;40;Landes;87421;44939;42482;80411;113030;76277;46095;403234
2015;41;Loir-et-Cher;77115;39574;37541;66125;90314;59310;40186;333050
2015;42;Loire;186752;95512;91240;168579;195955;126183;81942;759411
2015;43;Haute-Loire;52301;26947;25354;44559;63386;40662;26126;227034
2015;44;Loire-Atlantique;353654;180799;172855;341554;358080;197348;114591;1365227
2015;45;Loiret;171396;87688;83708;156747;178090;104543;62573;673349
2015;46;Lot;33986;17346;16640;29816;47974;36851;24773;173400
2015;47;Lot-et-Garonne;72810;37330;35480;65592;89172;63458;42385;333417
2015;48;Lozère;16278;8419;7859;15218;21362;14155;9296;76309
2015;49;Maine-et-Loire;212335;108247;104088;191428;208925;119888;77610;810186
2015;50;Manche;113790;58303;55487;100521;136327;88345;60304;499287
2015;51;Marne;141407;72415;68992;143589;150348;87657;49292;572293
2015;52;Haute-Marne;39350;20204;19146;36987;49311;32536;20970;179154
2015;53;Mayenne;79479;40764;38715;64607;81579;48137;34138;307940
2015;54;Meurthe-et-Moselle;176370;90193;86177;189203;191963;110570;66297;734403
2015;55;Meuse;44584;23056;21528;41533;52317;32225;19967;190626
2015;56;Morbihan;172978;89031;83947;149829;203900;135096;83010;744813
2015;57;Moselle;237911;122597;115314;253740;296804;162457;93574;1044486
2015;58;Nièvre;41863;21782;20081;38963;56495;44372;30054;211747
2015;59;Nord;702173;358813;343360;682136;668047;355511;197371;2605238
2015;60;Oise;219781;112354;107427;198330;227686;117055;58700;821552
2015;61;Orne;65342;33684;31658;55513;77258;52738;35767;286618
2015;62;Pas-de-Calais;387844;199208;188636;349953;392455;219046;123350;1472648
2015;63;Puy-de-Dôme;147173;74951;72222;152312;174415;109319;64282;647501
2015;64;Pyrénées-Atlantiques;145785;74857;70928;143749;185902;116386;78210;670032
2015;65;Hautes-Pyrénées;47105;24324;22781;42950;63640;43863;31024;228582
2015;66;Pyrénées-Orientales;105943;54594;51349;95164;123209;89184;57538;471038
2015;67;Bas-Rhin;262537;133791;128746;287333;311040;163558;92190;1116658
2015;68;Haut-Rhin;182359;93380;88979;178394;216769;118009;67076;762607
2015;69;Rhône;471192;239173;232019;515805;447849;239525;147624;1821995
2015;70;Haute-Saône;56302;29288;27014;48492;66760;42253;23899;237706
2015;71;Saône-et-Loire;122031;63018;59013;109011;151811;104272;68283;555408
2015;72;Sarthe;142285;72569;69716;123026;151536;91933;59665;568445
2015;73;Savoie;100996;51988;49008;99167;119849;68201;39991;428204
2015;74;Haute-Savoie;198857;102156;96701;205514;221292;111080;57195;793938
2015;75;Paris;433635;217507;216128;741848;559300;304064;167641;2206488
2015;76;Seine-Maritime;314082;160271;153811;303487;332329;194819;112982;1257699
2015;77;Seine-et-Marne;390955;199643;191312;357708;383601;175073;82784;1390121
2015;78;Yvelines;385095;197128;187967;352236;392928;193285;103747;1427291
2015;79;Deux-Sèvres;87980;45309;42671;76391;103585;63328;43151;374435
2015;80;Somme;142681;72962;69719;137407;151473;89632;50686;571879
2015;81;Tarn;87160;44455;42705;76519;105161;68897;48806;386543
2015;82;Tarn-et-Garonne;62435;32210;30225;53682;69063;42660;27434;255274
2015;83;Var;223768;114958;108810;217276;280406;203262;123940;1048652
2015;84;Vaucluse;134844;69255;65589;121023;151578;95526;54577;557548
2015;85;Vendée;159723;81784;77939;136971;176405;120889;72726;666714
2015;86;Vienne;103266;52298;50968;101708;113128;70431;46354;434887
2015;87;Haute-Vienne;81749;41415;40334;81625;100148;67439;44834;375795
2015;88;Vosges;84633;43229;41404;76254;103647;66204;41278;372016
2015;89;Yonne;79728;41175;38553;68659;92308;61967;38241;340903
2015;90;Territoire de Belfort;35523;18685;16838;35995;38314;21765;12886;144483
2015;91;Essonne;350321;178782;171539;335168;343970;160683;86091;1276233
2015;92;Hauts-de-Seine;404220;205930;198290;465165;423850;192862;115472;1601569
2015;93;Seine-Saint-Denis;461941;235687;226254;464904;409174;173285;83359;1592663
2015;94;Val-de-Marne;353979;180549;173430;387936;364556;168993;96925;1372389
2015;95;Val-d'Oise;347346;176999;170347;328593;322445;146556;70450;1215390
2015;971;Guadeloupe;108057;54796;53261;79873;120711;59972;29377;397990
2015;972;Martinique;92633;47397;45236;75047;118815;61180;33202;380877
2015;973;Guyane;110811;56262;54549;73521;55355;15921;4257;259865
2015;974;La Réunion;270934;138820;132114;215951;236785;91992;35065;850727
2015;976;Mayotte;124801;61714;63087;61755;35613;7899;2121;232189
2016;01;Ain;167230;85905;81325;148347;178058;94873;49917;638425
2016;02;Aisne;136758;69993;66765;118304;143530;88632;48912;536136
2016;03;Allier;70470;36066;34404;63976;91651;68357;44930;339384
2016;04;Alpes-de-Haute-Provence;35133;18335;16798;30568;44747;32668;19449;162565
2016;05;Hautes-Alpes;31420;16241;15179;28552;39065;26359;15711;141107
2016;06;Alpes-Maritimes;231355;118765;112590;241844;287169;190985;132351;1083704
2016;07;Ardèche;73033;37507;35526;62729;90045;62494;36856;325157
2016;08;Ardennes;65909;33898;32011;59261;75937;47149;27115;275371
2016;09;Ariège;32313;16711;15602;29377;42246;30071;19060;153067
2016;10;Aube;75441;38786;36655;69677;80562;52432;30798;308910
2016;11;Aude;80328;40956;39372;71920;98275;73561;43941;368025
2016;12;Aveyron;57921;30228;27693;52055;75581;54702;38438;278697
2016;13;Bouches-du-Rhône;485093;247485;237608;490519;531142;322465;190498;2019717
2016;14;Calvados;168551;86378;82173;158816;180161;118391;67760;693679
2016;15;Cantal;27874;14132;13742;26580;41125;30014;20376;145969
2016;16;Charente;75293;38924;36369;70666;97198;67613;42518;353288
2016;17;Charente-Maritime;134154;69004;65150;124366;169162;134460;80049;642191
2016;18;Cher;66551;34278;32273;60300;83683;59515;37061;307110
2016;19;Corrèze;48944;25435;23509;46839;65199;47825;32728;241535
2016;21;Côte-d'Or;125581;63964;61617;129881;139341;87203;51207;533213
2016;22;Côtes-d'Armor;136901;70147;66754;112367;158649;116822;74214;598953
2016;23;Creuse;21851;11303;10548;20227;32975;25951;18498;119502
2016;24;Dordogne;81770;42012;39758;72953;113902;89173;56991;414789
2016;25;Doubs;135376;69373;66003;133493;138013;83024;48643;538549
2016;26;Drôme;124934;64542;60392;109513;136016;87903;49640;508006
2016;27;Eure;157517;81084;76433;133749;165343;96769;49447;602825
2016;28;Eure-et-Loir;110088;56279;53809;95242;117242;70326;41031;433929
2016;29;Finistère;210042;107879;102163;193701;245507;159925;99074;908249
2016;2A;Corse-du-Sud;30761;15959;14802;34712;43736;28180;16914;154303
2016;2B;Haute-Corse;36906;19045;17861;40639;48377;31548;18682;176152
2016;30;Gard;174876;89523;85353;156052;200856;135470;74752;742006
2016;31;Haute-Garonne;330512;167837;162675;384138;350222;180192;103119;1348183
2016;32;Gers;39004;20134;18870;33518;53553;38641;25948;190664
2016;33;Gironde;371473;189537;181936;398695;417575;242652;136284;1566679
2016;34;Hérault;264508;135188;129320;277961;287924;193182;108906;1132481
2016;35;Ille-et-Vilaine;272447;138681;133766;269290;273505;146950;89587;1051779
2016;36;Indre;45943;23505;22438;40615;61092;45322;30533;223505
2016;37;Indre-et-Loire;145423;73694;71729;139022;158743;100435;62600;606223
2016;38;Isère;323046;165794;157252;305489;334358;187155;102864;1252912
2016;39;Jura;60641;31204;29437;53115;71541;46521;28699;260517
2016;40;Landes;86864;44636;42228;79936;112705;78632;46873;405010
2016;41;Loir-et-Cher;76326;39133;37193;65458;90024;60874;40087;332769
2016;42;Loire;187819;96302;91517;168612;195172;128290;82104;761997
2016;43;Haute-Loire;52072;26930;25142;44390;63220;41844;25813;227339
2016;44;Loire-Atlantique;356179;182376;173803;345308;360024;204234;115107;1380852
2016;45;Loiret;171277;87927;83350;155927;177129;107217;62780;674330
2016;46;Lot;33253;16973;16280;29639;47481;38022;24952;173347
2016;47;Lot-et-Garonne;72336;37039;35297;65386;88156;64693;42262;332833
2016;48;Lozère;16324;8436;7888;15021;21172;14551;9354;76422
2016;49;Maine-et-Loire;211777;108054;103723;188700;207983;123950;78524;810934
2016;50;Manche;112227;57638;54589;100252;134543;90911;60429;498362
2016;51;Marne;140462;72067;68395;142271;149033;89827;49290;570883
2016;52;Haute-Marne;38574;19742;18832;36842;48403;33285;20980;178084
2016;53;Mayenne;78841;40456;38385;64171;81464;49512;33700;307688
2016;54;Meurthe-et-Moselle;176783;90556;86227;187306;189830;113234;66668;733821
2016;55;Meuse;44179;22895;21284;40284;51567;33275;19750;189055
2016;56;Morbihan;172222;88670;83552;148955;203100;139662;83609;747548
2016;57;Moselle;237564;122397;115167;251965;294004;167665;94073;1045271
2016;58;Nièvre;41250;21447;19803;37784;55318;45216;29593;209161
2016;59;Nord;697583;356669;340914;678766;664102;364814;198458;2603723
2016;60;Oise;219840;112436;107404;197915;226120;120987;58680;823542
2016;61;Orne;64801;33305;31496;54767;75985;54007;35748;285308
2016;62;Pas-de-Calais;385592;198094;187498;346588;389731;226551;122263;1470725
2016;63;Puy-de-Dôme;147062;74734;72328;152805;173422;112496;64915;650700
2016;64;Pyrénées-Atlantiques;145706;74904;70802;143907;185428;119866;79079;673986
2016;65;Hautes-Pyrénées;46094;23839;22255;43066;62681;45430;30558;227829
2016;66;Pyrénées-Orientales;105850;54262;51588;95551;123538;91537;57893;474369
2016;67;Bas-Rhin;263597;134175;129422;285817;309685;169088;93220;1121407
2016;68;Haut-Rhin;181219;93080;88139;176500;215781;121630;67613;762743
2016;69;Rhône;472805;239784;233021;518837;449514;245717;149030;1835903
2016;70;Haute-Saône;55817;29006;26811;47637;66043;43525;24220;237242
2016;71;Saône-et-Loire;121882;62901;58981;108806;149935;106256;68144;555023
2016;72;Sarthe;141348;72315;69033;121336;150378;94682;59817;567561
2016;73;Savoie;101471;52122;49349;98112;119513;70100;40485;429681
2016;74;Haute-Savoie;199925;103035;96890;207087;222463;113614;58327;801416
2016;75;Paris;426463;213457;213006;737329;552963;306400;167172;2190327
2016;76;Seine-Maritime;313026;159881;153145;301409;328051;199721;113548;1255755
2016;77;Seine-et-Marne;391326;200180;191146;358602;382982;180785;83970;1397665
2016;78;Yvelines;387109;198261;188848;348655;393159;197050;105835;1431808
2016;79;Deux-Sèvres;88499;45579;42920;75369;103003;65166;42706;374743
2016;80;Somme;142287;72714;69573;136983;150543;92188;50743;572744
2016;81;Tarn;86442;44171;42271;75767;104313;71100;48826;386448
2016;82;Tarn-et-Garonne;62833;32380;30453;53807;69388;43670;27199;256897
2016;83;Var;224498;115537;108961;217054;280637;206998;126634;1055821
2016;84;Vaucluse;134540;68946;65594;121165;150565;97412;55332;559014
2016;85;Vendée;158585;81495;77090;135897;176693;125542;73880;670597
2016;86;Vienne;104034;52705;51329;100606;112155;72855;46419;436069
2016;87;Haute-Vienne;81554;41120;40434;80440;99049;69433;44502;374978
2016;88;Vosges;82531;42221;40310;75493;102256;68068;41293;369641
2016;89;Yonne;78815;40754;38061;68604;91244;63422;38459;340544
2016;90;Territoire de Belfort;35102;18466;16636;35508;38050;22409;13020;144089
2016;91;Essonne;354605;181348;173257;336258;346357;163484;86626;1287330
2016;92;Hauts-de-Seine;402677;205241;197436;462542;425114;196767;116168;1603268
2016;93;Seine-Saint-Denis;466932;237688;229244;466149;411238;178681;83660;1606660
2016;94;Val-de-Marne;354431;180941;173490;387340;366241;173098;97041;1378151
2016;95;Val-d'Oise;348945;177537;171408;328470;322384;150840;71284;1221923
2016;971;Guadeloupe;105095;53336;51759;77446;119445;62234;29890;394110
2016;972;Martinique;89415;45457;43958;72718;117552;62616;34179;376480
2016;973;Guyane;113425;57410;56015;76198;58062;17092;4575;269352
2016;974;La Réunion;269139;137123;132016;211845;238552;96439;36949;852924
2016;976;Mayotte;129531;64053;65478;64093;36962;8200;2201;240987
2017;01;Ain;167436;86204;81232;149167;178495;97596;50656;643350
2017;02;Aisne;135238;69558;65680;117461;141427;91681;48683;534490
2017;03;Allier;69603;35659;33944;63788;89746;69527;45324;337988
2017;04;Alpes-de-Haute-Provence;35009;18320;16689;31172;44555;33484;19695;163915
2017;05;Hautes-Alpes;30987;15960;15027;28300;38863;27167;15967;141284
2017;06;Alpes-Maritimes;230534;117831;112703;239490;286482;193668;133136;1083310
2017;07;Ardèche;72319;37107;35212;62210;89649;64118;37416;325712
2017;08;Ardennes;64962;33469;31493;58483;74727;48675;26732;273579
2017;09;Ariège;31968;16507;15461;29096;41710;30993;19386;153153
2017;10;Aube;75593;38801;36792;69899;79906;53803;30819;310020
2017;11;Aude;80818;41347;39471;71523;98007;75694;44218;370260
2017;12;Aveyron;57554;30006;27548;52009;75035;56031;38577;279206
2017;13;Bouches-du-Rhône;483764;247183;236581;489727;528237;328650;193784;2024162
2017;14;Calvados;165746;85056;80690;159523;178375;122166;68192;694002
2017;15;Cantal;27744;14051;13693;25970;40291;30913;20225;145143
2017;16;Charente;74328;38257;36071;70329;95358;69367;42953;352335
2017;17;Charente-Maritime;134043;69168;64875;122829;167871;138803;80757;644303
2017;18;Cher;64938;33257;31681;59510;81889;60872;37047;304256
2017;19;Corrèze;48547;25191;23356;46354;64361;49521;32681;241464
2017;21;Côte-d'Or;123924;62957;60967;130268;138306;89799;51522;533819
2017;22;Côtes-d'Armor;135511;69523;65988;111633;157667;120461;73542;598814
2017;23;Creuse;21831;11225;10606;19824;32376;26758;17849;118638
2017;24;Dordogne;80370;41419;38951;72735;112070;91473;56958;413606
2017;25;Doubs;134822;69109;65713;132863;137172;85497;48713;539067
2017;26;Drôme;124963;64277;60686;110056;135234;90188;51112;511553
2017;27;Eure;156208;80296;75912;132440;163765;99494;49936;601843
2017;28;Eure-et-Loir;109709;56159;53550;94209;116219;72180;40916;433233
2017;29;Finistère;207998;106915;101083;193066;243412;165954;98598;909028
2017;2A;Corse-du-Sud;31171;16299;14872;34842;44325;29237;17674;157249
2017;2B;Haute-Corse;36689;19059;17630;41322;48079;32659;18940;177689
2017;30;Gard;173500;89022;84478;156678;199453;138776;75771;744178
2017;31;Haute-Garonne;332102;168394;163708;388074;351728;185809;104959;1362672
2017;32;Gers;38779;20047;18732;33509;52905;39634;26264;191091
2017;33;Gironde;373459;190941;182518;403013;417998;250311;138603;1583384
2017;34;Hérault;266739;136329;130410;280097;288842;198318;110896;1144892
2017;35;Ille-et-Vilaine;274838;140232;134606;269042;274019;152200;90100;1060199
2017;36;Indre;45367;23285;22082;39848;59953;46592;30472;222232
2017;37;Indre-et-Loire;144821;73408;71413;138934;157289;102641;62826;606511
2017;38;Isère;323997;166430;157567;304304;334014;191177;105230;1258722
2017;39;Jura;60292;31003;29289;52496;70717;47775;28908;260188
2017;40;Landes;87147;45044;42103;79670;112790;80939;46898;407444
2017;41;Loir-et-Cher;75552;38813;36739;64806;89163;62324;40070;331915
2017;42;Loire;187457;96378;91079;168977;193817;130668;82022;762941
2017;43;Haute-Loire;51342;26501;24841;44138;62612;43389;25802;227283
2017;44;Loire-Atlantique;357100;183126;173974;349527;361658;210861;115763;1394909
2017;45;Loiret;173136;88786;84350;156451;175939;109871;62708;678105
2017;46;Lot;32986;16891;16095;29737;46942;39064;25099;173828
2017;47;Lot-et-Garonne;71826;36838;34988;65061;87257;66134;42564;332842
2017;48;Lozère;16073;8321;7752;15135;20978;15042;9373;76601
2017;49;Maine-et-Loire;211025;107747;103278;187029;207052;128430;79957;813493
2017;50;Manche;110739;56717;54022;99275;132430;94205;60234;496883
2017;51;Marne;139867;71486;68381;140937;146816;91944;49331;568895
2017;52;Haute-Marne;37648;19385;18263;36094;47248;34196;20454;175640
2017;53;Mayenne;77944;40017;37927;63622;80704;51467;33708;307445
2017;54;Meurthe-et-Moselle;175266;89683;85583;187184;187745;116702;66584;733481
2017;55;Meuse;43458;22525;20933;39510;50443;34413;19363;187187
2017;56;Morbihan;171357;88517;82840;148089;202270;145578;83569;750863
2017;57;Moselle;235585;121790;113795;250982;289298;172203;95454;1043522
2017;58;Nièvre;40669;21137;19532;36800;54249;46176;29288;207182
2017;59;Nord;693966;354659;339307;677232;658463;379023;195677;2604361
2017;60;Oise;218587;111445;107142;197394;224990;124793;58739;824503
2017;61;Orne;63732;32810;30922;53981;74412;55582;35665;283372
2017;62;Pas-de-Calais;382288;196132;186156;344112;385392;235695;120531;1468018
2017;63;Puy-de-Dôme;146785;74122;72663;153485;172422;115843;65207;653742
2017;64;Pyrénées-Atlantiques;145926;75143;70783;143876;184748;123094;79665;677309
2017;65;Hautes-Pyrénées;46579;24258;22321;43043;61966;46588;30354;228530
2017;66;Pyrénées-Orientales;104276;53219;51057;94922;122725;94053;58476;474452
2017;67;Bas-Rhin;263421;134249;129172;285907;306663;173691;95877;1125559
2017;68;Haut-Rhin;180585;92952;87633;175742;214027;124654;69022;764030
2017;69;Rhône;474630;240832;233798;519880;449456;248744;150609;1843319
2017;70;Haute-Saône;55110;28577;26533;47196;65223;44825;24305;236659
2017;71;Saône-et-Loire;121334;62738;58596;107273;147628;109115;68245;553595
2017;72;Sarthe;140684;72270;68414;120200;148473;97083;60066;566506
2017;73;Savoie;101386;52184;49202;97709;118959;71858;41262;431174
2017;74;Haute-Savoie;200499;103489;97010;208091;222608;116120;60042;807360
2017;75;Paris;422752;211555;211197;736749;550917;309022;168086;2187526
2017;76;Seine-Maritime;311142;158974;152168;300856;322287;205818;114275;1254378
2017;77;Seine-et-Marne;392026;200505;191521;358391;381646;186117;85817;1403997
2017;78;Yvelines;388195;198777;189418;348287;393546;200398;107840;1438266
2017;79;Deux-Sèvres;87366;45006;42360;75325;101829;67157;42674;374351
2017;80;Somme;141940;72612;69328;136520;148753;94670;50560;572443
2017;81;Tarn;86518;44244;42274;75696;104249;72862;48565;387890
2017;82;Tarn-et-Garonne;63172;32525;30647;53361;69988;44786;27042;258349
2017;83;Var;225082;116269;108813;216385;278203;210234;128836;1058740
2017;84;Vaucluse;134438;69015;65423;120540;149002;99208;56291;559479
2017;85;Vendée;157879;81173;76706;136320;176598;130514;73936;675247
2017;86;Vienne;103451;52264;51187;101111;110957;74612;46745;436876
2017;87;Haute-Vienne;81286;41047;40239;79617;97917;70980;44626;374426
2017;88;Vosges;81961;42231;39730;73979;100137;70611;40985;367673
2017;89;Yonne;77718;40341;37377;67286;90056;65004;38227;338291
2017;90;Territoire de Belfort;33980;17692;16288;35074;37578;22991;12999;142622
2017;91;Essonne;356565;182536;174029;336198;347644;167806;87917;1296130
2017;92;Hauts-de-Seine;402708;204915;197793;461396;426784;200869;117549;1609306
2017;93;Seine-Saint-Denis;473039;240629;232410;471049;413251;182706;83066;1623111
2017;94;Val-de-Marne;359413;183559;175854;388307;366355;176682;97169;1387926
2017;95;Val-d'Oise;351331;178917;172414;328428;322682;154421;71756;1228618
2017;971;Guadeloupe;101242;51225;50017;75739;117393;64725;31154;390253
2017;972;Martinique;86666;43803;42863;70375;115079;65218;35256;372594
2017;973;Guyane;113266;57104;56162;74738;57520;18313;4863;268700
2017;974;La Réunion;264572;134596;129976;209546;238983;101811;38747;853659
2017;976;Mayotte;134454;66487;67967;66527;38368;8515;2279;250143
2018;01;Ain;167453;86402;81051;150262;178340;99851;51728;647634
2018;02;Aisne;134403;69161;65242;116346;139838;94077;48652;533316
2018;03;Allier;70025;36152;33873;62473;88566;70752;45355;337171
2018;04;Alpes-de-Haute-Provence;34584;18148;16436;30670;44276;34197;20341;164068
2018;05;Hautes-Alpes;30341;15759;14582;27833;38543;28270;15711;140698
2018;06;Alpes-Maritimes;231034;118341;112693;239120;285842;195649;134574;1086219
2018;07;Ardèche;72319;36963;35356;61951;89001;65918;37417;326606
2018;08;Ardennes;64051;33021;31030;57851;73710;49775;26458;271845
2018;09;Ariège;31454;16262;15192;29180;41437;31611;19384;153066
2018;10;Aube;75858;39183;36675;69747;78955;54638;30822;310020
2018;11;Aude;81039;41623;39416;71508;98189;77756;44314;372806
2018;12;Aveyron;57301;29952;27349;52269;73851;57338;38515;279274
2018;13;Bouches-du-Rhône;486679;248072;238607;490502;527275;333387;196514;2034357
2018;14;Calvados;164621;84470;80151;159104;176277;125642;68412;694056
2018;15;Cantal;27601;13993;13608;26084;39623;31574;19883;144765
2018;16;Charente;73907;38091;35816;70259;94263;70889;42460;351778
2018;17;Charente-Maritime;132747;68446;64301;122247;167238;142525;82175;646932
2018;18;Cher;64273;32931;31342;59829;80545;62058;36703;303408
2018;19;Corrèze;49052;25718;23334;44760;63724;50647;32400;240583
2018;21;Côte-d'Or;123485;62579;60906;129273;136741;91590;52131;533220
2018;22;Côtes-d'Armor;135403;69512;65891;110570;156760;123667;73184;599584
2018;23;Creuse;21401;11004;10397;19576;31653;27399;17474;117503
2018;24;Dordogne;80149;41193;38956;72172;110612;93765;56720;413418
2018;25;Doubs;135001;69054;65947;133044;136886;87227;49296;541454
2018;26;Drôme;125305;64311;60994;110592;135259;91694;51882;514732
2018;27;Eure;154355;79234;75121;131241;162318;102304;49744;599962
2018;28;Eure-et-Loir;109180;55985;53195;92652;115433;73809;40923;431997
2018;29;Finistère;206203;105980;100223;192667;242379;172354;98132;911735
2018;2A;Corse-du-Sud;31894;16615;15279;34697;43747;29209;18306;157853
2018;2B;Haute-Corse;37126;19310;17816;42227;48631;33288;19429;180701
2018;30;Gard;172854;88722;84132;155052;198358;142084;77110;745458
2018;31;Haute-Garonne;334809;169582;165227;392831;354905;191581;106546;1380672
2018;32;Gers;38779;20150;18629;33263;52691;40492;26058;191283
2018;33;Gironde;376552;191575;184977;407185;420836;256861;140411;1601845
2018;34;Hérault;267831;136099;131732;283928;290753;203414;113294;1159220
2018;35;Ille-et-Vilaine;274994;140249;134745;270249;276079;156750;91156;1069228
2018;36;Indre;44714;22884;21830;39446;58871;47188;30376;220595
2018;37;Indre-et-Loire;144640;73509;71131;138953;156620;105350;62197;607760
2018;38;Isère;325547;167005;158542;302743;333755;194621;106897;1263563
2018;39;Jura;59452;30526;28926;52372;70048;48809;29065;259746
2018;40;Landes;87450;45303;42147;79027;113146;83798;46934;410355
2018;41;Loir-et-Cher;74719;38461;36258;63857;87797;64089;39786;330248
2018;42;Loire;186655;96121;90534;168755;192450;133076;82505;763441
2018;43;Haute-Loire;51356;26521;24835;43703;62106;44555;25832;227552
2018;44;Loire-Atlantique;360864;184985;175879;351986;365159;217315;117178;1412502
2018;45;Loiret;172229;88375;83854;156517;175101;112334;62664;678845
2018;46;Lot;32509;16787;15722;30008;46319;40203;24890;173929
2018;47;Lot-et-Garonne;71418;36558;34860;64486;86302;67081;42683;331970
2018;48;Lozère;15840;8236;7604;15040;20843;15453;9344;76520
2018;49;Maine-et-Loire;209703;107085;102618;188167;206621;131502;79890;815883
2018;50;Manche;109307;55940;53367;98932;131144;96835;59765;495983
2018;51;Marne;138877;70980;67897;139628;145671;94146;49140;567462
2018;52;Haute-Marne;36995;19059;17936;35772;46339;34634;20329;174069
2018;53;Mayenne;77080;39632;37448;63339;80136;52628;33901;307084
2018;54;Meurthe-et-Moselle;174635;89154;85481;186560;186852;119096;66326;733469
2018;55;Meuse;42369;21984;20385;38754;49560;35401;19271;185355
2018;56;Morbihan;170149;87929;82220;147676;201790;150923;84329;754867
2018;57;Moselle;235742;121766;113976;249415;286633;176226;95508;1043524
2018;58;Nièvre;40398;20999;19399;36498;53009;46751;29172;205828
2018;59;Nord;692671;353871;338800;673277;655256;390899;194131;2606234
2018;60;Oise;218343;111290;107053;197245;224255;127588;59722;827153
2018;61;Orne;62508;32221;30287;53506;73312;56993;35274;281593
2018;62;Pas-de-Calais;379377;194709;184668;341727;382408;243716;119515;1466743
2018;63;Puy-de-Dôme;148868;75231;73637;155024;171835;118028;65293;659048
2018;64;Pyrénées-Atlantiques;145314;74714;70600;143878;184189;125785;80644;679810
2018;65;Hautes-Pyrénées;46673;24249;22424;43322;61371;47449;30376;229191
2018;66;Pyrénées-Orientales;104440;53575;50865;94292;122865;95475;59285;476357
2018;67;Bas-Rhin;264503;134617;129886;287419;305980;178528;97122;1133552
2018;68;Haut-Rhin;179434;92318;87116;174826;212390;127960;70371;764981
2018;69;Rhône;480311;243220;237091;522227;452894;251471;152621;1859524
2018;70;Haute-Saône;54623;28420;26203;46897;64494;45797;24207;236018
2018;71;Saône-et-Loire;120524;62258;58266;106092;145993;111543;68033;552185
2018;72;Sarthe;139292;71731;67561;119741;147316;99654;59960;565963
2018;73;Savoie;101084;52102;48982;98419;118863;73569;41789;433724
2018;74;Haute-Savoie;202232;104608;97624;208236;225818;118565;61848;816699
2018;75;Paris;417262;208840;208422;733438;545609;309851;169441;2175601
2018;76;Seine-Maritime;310600;159004;151596;300839;319410;211282;113752;1255883
2018;77;Seine-et-Marne;393043;201204;191839;358280;382008;191412;87773;1412516
2018;78;Yvelines;388835;199378;189457;346011;395070;201779;109703;1441398
2018;79;Deux-Sèvres;86639;44691;41948;74876;101341;68935;43008;374799
2018;80;Somme;140106;71587;68519;135482;147183;97084;50807;570662
2018;81;Tarn;86150;44199;41951;75557;104029;74408;48452;388596
2018;82;Tarn-et-Garonne;62908;32623;30285;52871;69860;46167;27318;259124
2018;83;Var;225566;116694;108872;216657;278368;213976;133130;1067697
2018;84;Vaucluse;133502;68633;64869;120181;147575;101238;57297;559793
2018;85;Vendée;157453;80957;76496;135542;176879;135253;74864;679991
2018;86;Vienne;103034;52045;50989;101295;109725;76662;46870;437586
2018;87;Haute-Vienne;80528;40506;40022;79497;96567;72226;44381;373199
2018;88;Vosges;80989;41756;39233;73383;99007;72239;40494;366112
2018;89;Yonne;76966;39937;37029;66591;89056;66656;38235;337504
2018;90;Territoire de Belfort;34528;18271;16257;33435;37453;23425;13011;141852
2018;91;Essonne;356240;182662;173578;334101;346512;170319;89469;1296641
2018;92;Hauts-de-Seine;404893;206182;198711;463749;429758;203771;116949;1619120
2018;93;Seine-Saint-Denis;477029;242451;234578;472117;413404;187119;83008;1632677
2018;94;Val-de-Marne;361739;184376;177363;392938;366200;179117;96919;1396913
2018;95;Val-d'Oise;356597;181927;174670;328957;322940;158350;71737;1238581
2018;971;Guadeloupe;98355;49808;48547;74670;115667;66687;32250;387629
2018;972;Martinique;84126;42674;41452;69595;112262;66981;35819;368783
2018;973;Guyane;116367;58435;57932;77055;58397;19069;5240;276128
2018;974;La Réunion;263130;133669;129461;208297;238761;105448;40325;855961
2018;976;Mayotte;139558;69012;70546;69047;39823;8836;2357;259621
2019;01;Ain;169629;87601;82028;148849;178829;102281;52844;652432
2019;02;Aisne;133588;68733;64855;115580;137655;95956;48566;531345
2019;03;Allier;69487;35781;33706;62465;87252;71240;45531;335975
2019;04;Alpes-de-Haute-Provence;34831;18196;16635;30297;43729;34647;20804;164308
2019;05;Hautes-Alpes;30595;15864;14731;27481;38222;28898;16024;141220
2019;06;Alpes-Maritimes;233189;119337;113852;239709;287563;197248;136574;1094283
2019;07;Ardèche;73042;37360;35682;61548;88431;67049;38208;328278
2019;08;Ardennes;63776;32846;30930;57208;72468;50655;26475;270582
2019;09;Ariège;31578;16309;15269;28930;41128;32096;19555;153287
2019;10;Aube;75763;39077;36686;69695;78270;55651;30863;310242
2019;11;Aude;81218;41765;39453;71161;97666;78470;45555;374070
2019;12;Aveyron;57231;29790;27441;52295;73157;58276;38636;279595
2019;13;Bouches-du-Rhône;485338;247958;237380;491519;527109;338373;200771;2043110
2019;14;Calvados;162591;83722;78869;160230;174958;128048;69078;694905
2019;15;Cantal;27642;14012;13630;25953;39101;32032;19964;144692
2019;16;Charente;73777;38009;35768;70185;93083;72137;42833;352015
2019;17;Charente-Maritime;133325;68580;64745;122894;166669;144367;84103;651358
2019;18;Cher;64020;32721;31299;59382;79185;62735;36984;302306
2019;19;Corrèze;48851;25531;23320;44534;62906;51304;32478;240073
2019;21;Côte-d'Or;121319;61723;59596;131123;135882;93345;52455;534124
2019;22;Côtes-d'Armor;135520;69527;65993;110460;154801;125800;74001;600582
2019;23;Creuse;21350;10940;10410;19407;30818;27751;17291;116617
2019;24;Dordogne;79907;41022;38885;71872;109005;95062;57377;413223
2019;25;Doubs;134289;68748;65541;133859;137043;89019;49764;543974
2019;26;Drôme;125880;64512;61368;109862;134688;93255;53077;516762
2019;27;Eure;154485;79170;75315;129469;160800;104372;50381;599507
2019;28;Eure-et-Loir;109734;56294;53440;91478;114712;75040;40611;431575
2019;29;Finistère;205052;105347;99705;193345;240737;176336;99620;915090
2019;2A;Corse-du-Sud;32361;16845;15516;34039;43830;29552;18725;158507
2019;2B;Haute-Corse;36975;19282;17693;42502;48796;33595;20065;181933
2019;30;Gard;172903;88891;84012;155037;197144;144276;79077;748437
2019;31;Haute-Garonne;332599;169116;163483;400154;360448;197529;109309;1400039
2019;32;Gers;38964;20244;18720;33029;51989;41172;26223;191377
2019;33;Gironde;376615;192073;184542;413300;426496;263610;143728;1623749
2019;34;Hérault;268486;137056;131430;288803;294040;206870;117424;1175623
2019;35;Ille-et-Vilaine;273671;139747;133924;273977;278649;161130;92071;1079498
2019;36;Indre;44524;22776;21748;39202;57644;47502;30444;219316
2019;37;Indre-et-Loire;143147;72839;70308;140671;156061;107358;62842;610079
2019;38;Isère;324439;166444;157995;304113;334609;198715;109290;1271166
2019;39;Jura;59399;30410;28989;51802;69256;49491;29251;259199
2019;40;Landes;88325;45712;42613;78391;113329;85564;48081;413690
2019;41;Loir-et-Cher;74769;38407;36362;63363;86581;65014;39743;329470
2019;42;Loire;186413;96145;90268;169748;191521;134956;82996;765634
2019;43;Haute-Loire;51643;26591;25052;43342;61421;45228;25936;227570
2019;44;Loire-Atlantique;362765;185871;176894;354475;369175;223700;119157;1429272
2019;45;Loiret;172390;88377;84013;156257;174058;114381;63348;680434
2019;46;Lot;32673;16864;15809;29811;45498;40876;25236;174094
2019;47;Lot-et-Garonne;71365;36710;34655;64030;85274;67537;43065;331271
2019;48;Lozère;15793;8209;7584;15037;20579;15754;9441;76604
2019;49;Maine-et-Loire;206741;105748;100993;190480;205971;134876;80205;818273
2019;50;Manche;108878;55698;53180;98363;129122;98778;59904;495045
2019;51;Marne;136557;69683;66874;140530;144293;96048;49427;566855
2019;52;Haute-Marne;36638;18774;17864;35189;45251;35135;20299;172512
2019;53;Mayenne;76958;39541;37417;63144;79650;53681;33629;307062
2019;54;Meurthe-et-Moselle;170660;87386;83274;188939;185508;122274;66379;733760
2019;55;Meuse;42030;21705;20325;38281;48494;36090;19188;184083
2019;56;Morbihan;170877;88159;82718;147814;200366;154824;85803;759684
2019;57;Moselle;235229;121190;114039;248242;284029;181955;97088;1046543
2019;58;Nièvre;40251;20745;19506;36327;51697;47059;29118;204452
2019;59;Nord;683615;349528;334087;675244;652471;401458;195558;2608346
2019;60;Oise;219073;111431;107642;194990;223576;131226;60554;829419
2019;61;Orne;61935;31960;29975;53416;71794;57641;35156;279942
2019;62;Pas-de-Calais;375783;192580;183203;340065;378410;250437;120583;1465278
2019;63;Puy-de-Dôme;147582;74882;72700;156611;171427;120192;66340;662152
2019;64;Pyrénées-Atlantiques;145039;74354;70685;143567;183835;128566;81614;682621
2019;65;Hautes-Pyrénées;46597;24183;22414;43590;60592;48227;30561;229567
2019;66;Pyrénées-Orientales;105202;53939;51263;94518;122835;96735;60689;479979
2019;67;Bas-Rhin;262031;133940;128091;290095;304896;183997;99038;1140057
2019;68;Haut-Rhin;179574;92584;86990;173820;211031;131260;71401;767086
2019;69;Rhône;477028;242623;234405;529610;457565;256446;155098;1875747
2019;70;Haute-Saône;54564;28289;26275;46341;63626;46454;24328;235313
2019;71;Saône-et-Loire;120605;62005;58600;105652;143671;113018;68547;551493
2019;72;Sarthe;138884;71353;67531;119787;146120;101358;60263;566412
2019;73;Savoie;101399;52255;49144;98123;118933;75402;42577;436434
2019;74;Haute-Savoie;205999;106465;99534;205916;228638;121974;63567;826094
2019;75;Paris;410686;206856;203830;726942;545962;311637;170196;2165423
2019;76;Seine-Maritime;307407;157829;149578;301326;316697;215524;114679;1255633
2019;77;Seine-et-Marne;393446;201339;192107;356822;383444;197468;90017;1421197
2019;78;Yvelines;390066;200364;189702;343618;396389;206302;111832;1448207
2019;79;Deux-Sèvres;86985;44807;42178;74183;100485;70169;43056;374878
2019;80;Somme;137387;70496;66891;136707;145971;99162;51332;570559
2019;81;Tarn;86209;44249;41960;75570;103443;75826;48796;389844
2019;82;Tarn-et-Garonne;63612;33001;30611;52408;70092;46997;27560;260669
2019;83;Var;226819;117154;109665;216973;278856;216148;137915;1076711
2019;84;Vaucluse;133918;68842;65076;119385;147008;102496;58662;561469
2019;85;Vendée;159489;81930;77559;134440;177039;137950;76524;685442
2019;86;Vienne;101159;51417;49742;102996;109135;78127;47018;438435
2019;87;Haute-Vienne;79244;40252;38992;80241;95361;73010;44503;372359
2019;88;Vosges;80347;41391;38956;72727;97115;73794;40516;364499
2019;89;Yonne;76782;39794;36988;65694;87604;67386;38241;335707
2019;90;Territoire de Belfort;34367;18129;16238;33142;36926;23880;13003;141318
2019;91;Essonne;356326;182490;173836;332142;346586;175448;91157;1301659
2019;92;Hauts-de-Seine;407745;208012;199733;456431;433477;209354;117350;1624357
2019;93;Seine-Saint-Denis;482256;245613;236643;466414;418395;193328;84510;1644903
2019;94;Val-de-Marne;363674;185295;178379;391237;368834;185187;98192;1407124
2019;95;Val-d'Oise;360037;184112;175925;327422;324670;164650;72895;1249674
2019;971;Guadeloupe;95719;48288;47431;74175;112954;68569;32822;384239
2019;972;Martinique;82145;41542;40603;69074;108914;68640;35735;364508
2019;973;Guyane;118168;59163;59005;77788;59911;20301;5510;281678
2019;974;La Réunion;260947;132263;128684;207824;239477;110591;42371;861210
2019;976;Mayotte;144920;71663;73257;71696;41350;9172;2441;269579
2020;01;Ain;170220;87850;82370;149199;180000;104799;53638;657856
2020;02;Aisne;131255;67471;63784;115693;135894;97798;48734;529374
2020;03;Allier;68639;35223;33416;62570;86107;72513;45799;335628
2020;04;Alpes-de-Haute-Provence;34704;17963;16741;30655;43729;35364;20999;165451
2020;05;Hautes-Alpes;29682;15370;14312;27101;37723;29585;16514;140605
2020;06;Alpes-Maritimes;231865;118780;113085;238190;286952;200202;140201;1097410
2020;07;Ardèche;72242;37148;35094;61483;88061;68701;38838;329325
2020;08;Ardennes;63202;32544;30658;57010;71450;51785;26254;269701
2020;09;Ariège;31842;16520;15322;28877;40807;32967;19461;153954
2020;10;Aube;76308;39597;36711;69712;77760;56161;31494;311435
2020;11;Aude;80030;41189;38841;71304;97644;79649;46590;375217
2020;12;Aveyron;56530;29345;27185;52232;72656;59408;38728;279554
2020;13;Bouches-du-Rhône;480858;246005;234853;492111;525822;343846;205433;2048070
2020;14;Calvados;163862;84292;79570;159750;174111;131070;68754;697547
2020;15;Cantal;27489;13993;13496;25970;38682;32473;19765;144379
2020;16;Charente;73729;38207;35522;69854;92170;73292;42673;351718
2020;17;Charente-Maritime;133025;68673;64352;122763;167092;147994;84835;655709
2020;18;Cher;63748;32602;31146;59086;77303;63609;37187;300933
2020;19;Corrèze;47715;24880;22835;44920;62169;51819;32567;239190
2020;21;Côte-d'Or;121391;61603;59788;130590;134840;95117;53140;535078
2020;22;Côtes-d'Armor;135016;69117;65899;111650;154303;128600;74071;603640
2020;23;Creuse;21077;10832;10245;19333;30267;28255;17063;115995
2020;24;Dordogne;78537;40436;38101;71907;108152;97034;57177;412807
2020;25;Doubs;134249;68860;65389;133374;136952;90093;50541;545209
2020;26;Drôme;124373;64157;60216;109858;134309;94958;54211;517709
2020;27;Eure;153451;78500;74951;129760;159746;106165;50546;599668
2020;28;Eure-et-Loir;108818;55891;52927;91490;114316;76406;40413;431443
2020;29;Finistère;203935;104846;99089;192640;239130;180934;100540;917179
2020;2A;Corse-du-Sud;32605;16808;15797;34415;44280;30336;19178;160814
2020;2B;Haute-Corse;36319;18827;17492;42626;48880;34619;20443;182887
2020;30;Gard;172000;88337;83663;154370;196244;147375;81468;751457
2020;31;Haute-Garonne;334342;170054;164288;404123;363352;201899;112041;1415757
2020;32;Gers;38857;20200;18657;32745;51902;42023;26292;191819
2020;33;Gironde;377168;191899;185269;416214;427660;268466;146883;1636391
2020;34;Hérault;270415;137565;132850;291020;296380;210451;120707;1188973
2020;35;Ille-et-Vilaine;273721;139943;133778;276346;279244;165901;93643;1088855
2020;36;Indre;43760;22385;21375;39250;56768;48357;30572;218707
2020;37;Indre-et-Loire;142233;72648;69585;141670;155330;109147;63739;612119
2020;38;Isère;324217;166306;157911;304085;334922;202600;111689;1277513
2020;39;Jura;58462;29862;28600;51821;68534;50324;29657;258798
2020;40;Landes;88101;45651;42450;79002;113677;87980;49362;418122
2020;41;Loir-et-Cher;74367;38259;36108;63270;85889;66189;39642;329357
2020;42;Loire;186751;96468;90283;168982;191050;137388;84337;768508
2020;43;Haute-Loire;50912;26305;24607;43404;60562;46456;26155;227489
2020;44;Loire-Atlantique;362743;185689;177054;359109;371254;230164;121901;1445171
2020;45;Loiret;171534;88095;83439;155521;174099;116614;64536;682304
2020;46;Lot;33054;17035;16019;29574;45217;42034;24791;174670
2020;47;Lot-et-Garonne;70820;36419;34401;63346;84532;68778;43368;330844
2020;48;Lozère;16026;8395;7631;14981;20490;16035;9101;76633
2020;49;Maine-et-Loire;207680;106141;101539;189876;205145;138103;79909;820713
2020;50;Manche;108243;55790;52453;98580;128269;101478;58523;495093
2020;51;Marne;136379;69560;66819;139751;143029;97985;49515;566659
2020;52;Haute-Marne;36290;18653;17637;34986;44203;36032;20287;171798
2020;53;Mayenne;76439;39384;37055;63013;78871;54922;33293;306538
2020;54;Meurthe-et-Moselle;170446;87390;83056;187468;183737;124651;66288;732590
2020;55;Meuse;41034;21224;19810;38111;47662;37014;19180;183001
2020;56;Morbihan;170119;88158;81961;148181;199749;159944;86168;764161
2020;57;Moselle;234744;120816;113928;248658;281406;187284;97063;1049155
2020;58;Nièvre;39249;20167;19082;35870;50694;47807;29050;202670
2020;59;Nord;681029;348932;332097;670937;649696;409543;196541;2607746
2020;60;Oise;219240;111330;107910;193935;222628;133072;60824;829699
2020;61;Orne;61124;31755;29369;52770;70712;58705;35164;278475
2020;62;Pas-de-Calais;372334;191071;181263;336837;376108;256550;120338;1462167
2020;63;Puy-de-Dôme;148914;75509;73405;154149;170049;122037;66703;661852
2020;64;Pyrénées-Atlantiques;145229;75039;70190;143772;183720;132502;82017;687240
2020;65;Hautes-Pyrénées;46080;23996;22084;44216;59781;49010;30701;229788
2020;66;Pyrénées-Orientales;105134;53991;51143;94208;123424;99498;60501;482765
2020;67;Bas-Rhin;261999;133893;128106;291811;304346;189691;100226;1148073
2020;68;Haut-Rhin;177923;91861;86062;173599;210065;135009;71246;767842
2020;69;Rhône;475784;242565;233219;529554;459354;260079;158666;1883437
2020;70;Haute-Saône;54226;28009;26217;46060;63152;47276;23887;234601
2020;71;Saône-et-Loire;119364;61650;57714;105136;142651;114830;69082;551063
2020;72;Sarthe;137645;70684;66961;120127;145416;103365;60440;566993
2020;73;Savoie;101734;52708;49026;99305;118813;77117;42781;439750
2020;74;Haute-Savoie;206680;106778;99902;209281;229535;124221;65489;835206
2020;75;Paris;405280;203671;201609;715136;539898;312314;173278;2145906
2020;76;Seine-Maritime;305272;156563;148709;300887;312908;219642;116030;1254739
2020;77;Seine-et-Marne;391431;200228;191203;358578;384056;202623;91948;1428636
2020;78;Yvelines;387059;198603;188456;345225;394362;208723;114354;1449723
2020;79;Deux-Sèvres;86209;44480;41729;74110;100068;71867;42227;374481
2020;80;Somme;137272;70501;66771;135172;144084;100895;51325;568748
2020;81;Tarn;85576;43982;41594;75277;102743;77679;49791;391066
2020;82;Tarn-et-Garonne;63608;32838;30770;52594;70262;48084;27768;262316
2020;83;Var;225243;116575;108668;219523;278463;220155;141805;1085189
2020;84;Vaucluse;132417;68196;64221;119523;146620;103815;59566;561941
2020;85;Vendée;159544;82317;77227;133938;177826;142876;78521;692705
2020;86;Vienne;101593;51433;50160;103292;108502;79214;46731;439332
2020;87;Haute-Vienne;78763;40069;38694;80301;94461;74243;44355;372123
2020;88;Vosges;78912;40645;38267;72253;95255;75560;40417;362397
2020;89;Yonne;75790;39168;36622;65474;86749;68033;38110;334156
2020;90;Territoire de Belfort;33730;17664;16066;32571;36345;24233;13241;140120
2020;91;Essonne;353924;181054;172870;334377;345360;178127;94330;1306118
2020;92;Hauts-de-Seine;402101;205003;197098;457041;434343;212763;119965;1626213
2020;93;Seine-Saint-Denis;481326;245706;235620;468566;421163;198676;85691;1655422
2020;94;Val-de-Marne;359613;183473;176140;391400;367580;189325;100054;1407972
2020;95;Val-d'Oise;356934;182812;174122;327413;323792;169170;74495;1251804
2020;971;Guadeloupe;93699;47684;46015;73301;111300;71453;33806;383559
2020;972;Martinique;79594;40061;39533;68673;106060;70684;36214;361225
2020;973;Guyane;118987;59634;59353;78568;60584;21073;5921;285133
2020;974;La Réunion;257801;130967;126834;206054;239355;115742;44131;863083
2020;976;Mayotte;150367;74359;76008;74388;42900;9513;2528;279696
2021;01;Ain;170271;87945;82326;149203;181355;107080;54123;662032
2021;02;Aisne;129149;66353;62796;114953;134760;99463;48658;526983
2021;03;Allier;67560;34685;32875;62460;85010;73343;46008;334381
2021;04;Alpes-de-Haute-Provence;34388;17746;16642;30769;43593;35918;21162;165830
2021;05;Hautes-Alpes;29152;15135;14017;26792;37359;30250;16677;140230
2021;06;Alpes-Maritimes;231909;118821;113088;237952;287232;203211;141947;1102251
2021;07;Ardèche;71584;36885;34699;61488;87895;69618;39427;330012
2021;08;Ardennes;62426;32136;30290;56391;70458;52830;26111;268216
2021;09;Ariège;31548;16295;15253;28949;40526;33648;19551;154222
2021;10;Aube;76261;39570;36691;69833;77493;56670;31574;311831
2021;11;Aude;79461;40943;38518;71582;97627;80850;47365;376885
2021;12;Aveyron;55957;29009;26948;52231;72293;60398;38692;279571
2021;13;Bouches-du-Rhône;480045;245588;234457;491440;526916;348873;207728;2055002
2021;14;Calvados;162712;83677;79035;159461;173842;133257;69398;698670
2021;15;Cantal;27359;13923;13436;25833;38238;33057;19636;144123
2021;16;Charente;73016;37766;35250;69774;91525;74444;42817;351576
2021;17;Charente-Maritime;131520;67878;63642;123379;167662;150729;86089;659379
2021;18;Cher;63121;32300;30821;58642;76348;64183;37252;299546
2021;19;Corrèze;46990;24538;22452;44873;61621;52629;32463;238576
2021;21;Côte-d'Or;120441;61307;59134;130591;134406;96547;53290;535275
2021;22;Côtes-d'Armor;133829;68449;65380;112010;154101;130784;74487;605211
2021;23;Creuse;20767;10609;10158;19153;29673;28624;16833;115050
2021;24;Dordogne;77532;39966;37566;71845;107147;98608;57554;412686
2021;25;Doubs;133865;68664;65201;133237;137322;91212;50994;546630
2021;26;Drôme;123387;63593;59794;110117;134437;96296;55184;519421
2021;27;Eure;151773;77532;74241;128628;159329;108131;50543;598404
2021;28;Eure-et-Loir;107740;55334;52406;90822;113954;77551;40445;430512
2021;29;Finistère;201697;103576;98121;192878;238701;185388;101615;920279
2021;2A;Corse-du-Sud;32708;16852;15856;33905;44734;31065;19460;161872
2021;2B;Haute-Corse;36293;18797;17496;42620;49259;35458;20855;184485
2021;30;Gard;170707;87748;82959;153873;196154;149974;82801;753509
2021;31;Haute-Garonne;337803;171478;166325;406177;368411;207645;114232;1434268
2021;32;Gers;38464;20015;18449;32894;51431;42935;26435;192159
2021;33;Gironde;378671;192422;186249;419828;432657;274672;149497;1655325
2021;34;Hérault;273321;138941;134380;292841;299789;214337;123620;1203908
2021;35;Ille-et-Vilaine;273748;139921;133827;277789;282012;170272;95253;1099074
2021;36;Indre;42925;21964;20961;39429;55809;48740;30475;217378
2021;37;Indre-et-Loire;141433;72294;69139;142231;155422;110962;64071;614119
2021;38;Isère;323128;165630;157498;304848;335835;206185;112530;1282526
2021;39;Jura;57423;29356;28067;51692;68202;50904;29770;257991
2021;40;Landes;87584;45428;42156;79286;114411;90268;50123;421672
2021;41;Loir-et-Cher;73532;37862;35670;62934;85184;67115;39506;328271
2021;42;Loire;185915;96146;89769;169429;191017;138498;84253;769112
2021;43;Haute-Loire;50251;26012;24239;43408;60174;47322;25956;227111
2021;44;Loire-Atlantique;363690;186185;177505;362426;376706;236062;123622;1462506
2021;45;Loiret;171116;87995;83121;155409;173823;118443;65149;683940
2021;46;Lot;32852;16955;15897;29406;44971;42810;24868;174907
2021;47;Lot-et-Garonne;70260;36079;34181;62922;83839;69572;43396;329989
2021;48;Lozère;15930;8319;7611;14950;20285;16412;9016;76593
2021;49;Maine-et-Loire;206028;105317;100711;189823;205531;141369;80301;823052
2021;50;Manche;107017;55076;51941;98074;127166;103639;58578;494474
2021;51;Marne;135055;68774;66281;139329;142179;99459;49663;565685
2021;52;Haute-Marne;35500;18266;17234;34728;43486;36452;20114;170280
2021;53;Mayenne;75316;38805;36511;62979;78825;56032;32891;306043
2021;54;Meurthe-et-Moselle;169044;86587;82457;186579;183135;126753;65879;731390
2021;55;Meuse;40121;20762;19359;37696;46846;37644;18858;181165
2021;56;Morbihan;169032;87656;81376;147984;199926;164315;87360;768617
2021;57;Moselle;233246;119966;113280;247861;279896;192594;96015;1049612
2021;58;Nièvre;38608;19809;18799;35414;49881;48260;28854;201017
2021;59;Nord;675191;346057;329134;669093;649383;416384;197284;2607335
2021;60;Oise;218289;110871;107418;193419;222339;135462;61051;830560
2021;61;Orne;59983;31249;28734;52320;69753;59525;35019;276600
2021;62;Pas-de-Calais;367851;188812;179039;334864;374466;261667;120490;1459338
2021;63;Puy-de-Dôme;148944;75444;73500;154432;170172;123301;67340;664189
2021;64;Pyrénées-Atlantiques;144582;74682;69900;143847;183943;135799;82749;690920
2021;65;Hautes-Pyrénées;45666;23843;21823;44606;59515;49862;30494;230143
2021;66;Pyrénées-Orientales;104587;53550;51037;94162;124250;101387;61265;485651
2021;67;Bas-Rhin;261488;133503;127985;292893;304599;196163;99569;1154712
2021;68;Haut-Rhin;176232;91024;85208;172984;209331;138704;70385;767636
2021;69;Rhône;476739;243165;233574;531700;463313;264271;159403;1895426
2021;70;Haute-Saône;53228;27446;25782;45739;62761;47939;23826;233493
2021;71;Saône-et-Loire;118029;61008;57021;104809;141508;116196;68925;549467
2021;72;Sarthe;136128;70033;66095;120276;144768;105275;60621;567068
2021;73;Savoie;102038;52844;49194;99061;119271;78791;42738;441899
2021;74;Haute-Savoie;207610;107456;100154;210399;232276;126761;66629;843675
2021;75;Paris;399063;200283;198780;708931;536725;312543;173842;2131104
2021;76;Seine-Maritime;302786;155242;147544;300835;310669;222948;117096;1254334
2021;77;Seine-et-Marne;390229;199764;190465;359555;385073;207929;93293;1436079
2021;78;Yvelines;386469;198355;188114;344871;394424;211896;115192;1452852
2021;79;Deux-Sèvres;85413;44070;41343;73728;99686;73475;42126;374428
2021;80;Somme;135528;69553;65975;134732;143210;101843;51559;566872
2021;81;Tarn;84958;43803;41155;75254;102554;79333;50229;392328
2021;82;Tarn-et-Garonne;63374;32759;30615;52530;70575;49193;27832;263504
2021;83;Var;224276;116307;107969;221506;279358;223713;145274;1094127
2021;84;Vaucluse;131854;68025;63829;119015;146375;104824;60632;562700
2021;85;Vendée;158596;81877;76719;133939;178793;146973;80269;698570
2021;86;Vienne;101503;51518;49985;102990;108269;80586;46813;440161
2021;87;Haute-Vienne;78033;39580;38453;79992;93672;75325;44465;371487
2021;88;Vosges;77239;39829;37410;71723;94149;76681;40123;359915
2021;89;Yonne;74688;38533;36155;64891;86127;68743;38171;332620
2021;90;Territoire de Belfort;32989;17200;15789;32186;36149;24484;13168;138976
2021;91;Essonne;353229;180789;172440;334605;344646;181855;94557;1308892
2021;92;Hauts-de-Seine;399770;203802;195968;457441;436639;217222;120098;1631170
2021;93;Seine-Saint-Denis;482291;246073;236218;469947;423951;202924;85743;1664856
2021;94;Val-de-Marne;359029;183402;175627;392985;368442;193539;99786;1413781
2021;95;Val-d'Oise;357476;183167;174309;328166;325143;172902;74830;1258517
2021;971;Guadeloupe;91644;46706;44938;72827;108736;73329;35070;381606
2021;972;Martinique;76899;38827;38072;68143;102686;72467;36996;357191
2021;973;Guyane;120311;60236;60075;79784;61941;22262;6416;290714
2021;974;La Réunion;255661;129850;125811;204903;239185;121001;45919;866669
2021;976;Mayotte;155224;76763;78461;76788;44285;9822;2606;288725
2022;01;Ain;170644;88209;82435;149381;182322;108338;56286;666971
2022;02;Aisne;127328;65497;61831;114151;133577;99174;50493;524723
2022;03;Allier;66707;34182;32525;62330;83969;73059;47435;333500
2022;04;Alpes-de-Haute-Provence;34085;17542;16543;30984;43372;35934;21823;166198
2022;05;Hautes-Alpes;28689;14883;13806;26531;36961;30567;17330;140078
2022;06;Alpes-Maritimes;232495;119179;113316;237601;287591;203151;145395;1106233
2022;07;Ardèche;70808;36615;34193;61678;87456;70096;41176;331214
2022;08;Ardennes;61547;31700;29847;55834;69516;52936;26857;266690
2022;09;Ariège;31198;16077;15121;29077;40257;33811;20081;154424
2022;10;Aube;76193;39533;36660;69895;77056;56340;32699;312183
2022;11;Aude;79163;40881;38282;71633;97400;81025;49109;378330
2022;12;Aveyron;55395;28656;26739;52285;71806;60503;39650;279639
2022;13;Bouches-du-Rhône;479334;245289;234045;491709;526834;350503;213539;2061919
2022;14;Calvados;161509;83139;78370;159804;173061;133349;72068;699791
2022;15;Cantal;27323;13909;13414;25574;37824;33111;19971;143803
2022;16;Charente;72430;37477;34953;69842;90632;74528;43851;351283
2022;17;Charente-Maritime;130695;67507;63188;123392;168083;150972;89680;662822
2022;18;Cher;62316;31854;30462;58487;75150;64109;38187;298249
2022;19;Corrèze;46352;24170;22182;44830;60794;52562;33252;237790
2022;21;Côte-d'Or;119221;60641;58580;130925;133729;96708;55203;535786
2022;22;Côtes-d'Armor;133175;68103;65072;111937;154118;130813;76825;606868
2022;23;Creuse;20494;10454;10040;19002;29147;28488;17011;114142
2022;24;Dordogne;76603;39567;37036;71651;106115;98482;59137;411988
2022;25;Doubs;133746;68488;65258;132834;137493;91480;52905;548458
2022;26;Drôme;122504;63113;59391;110534;134384;96540;57357;521319
2022;27;Eure;150218;76595;73623;127745;158568;108443;52451;597425
2022;28;Eure-et-Loir;106858;54910;51948;89986;113656;77517;41553;429570
2022;29;Finistère;199882;102657;97225;192998;238154;186977;105389;923400
2022;2A;Corse-du-Sud;33021;17032;15989;33518;45062;31385;19938;162924
2022;2B;Haute-Corse;36231;18789;17442;42869;49482;35934;21390;185906
2022;30;Gard;169269;87047;82222;153954;195938;150502;85834;755497
2022;31;Haute-Garonne;342224;173632;168592;408104;372761;210603;118849;1452541
2022;32;Gers;38130;19856;18274;33056;51019;43037;27311;192553
2022;33;Gironde;381004;193208;187796;422968;437558;276750;155475;1673755
2022;34;Hérault;276341;140218;136123;294667;302678;215605;129183;1218474
2022;35;Ille-et-Vilaine;274467;140155;134312;278841;284713;171808;99143;1108972
2022;36;Indre;42397;21683;20714;39236;54950;48426;31232;216241
2022;37;Indre-et-Loire;141030;72129;68901;142478;155492;111153;65954;616107
2022;38;Isère;322152;165243;156909;305254;337021;207554;116520;1288501
2022;39;Jura;56471;28825;27646;51414;67751;51120;30548;257304
2022;40;Landes;87239;45224;42015;79525;114908;91168;52389;425229
2022;41;Loir-et-Cher;72696;37434;35262;62602;84550;66847;40693;327388
2022;42;Loire;185063;95681;89382;169719;190749;138030;87117;770678
2022;43;Haute-Loire;49614;25668;23946;43378;59875;47405;26825;227097
2022;44;Loire-Atlantique;365238;187102;178136;366542;380446;239070;128892;1480188
2022;45;Loiret;170502;87933;82569;155634;173456;118351;67138;685081
2022;46;Lot;32646;16957;15689;29408;44567;42951;25624;175196
2022;47;Lot-et-Garonne;69572;35739;33833;62484;83253;69306;44565;329180
2022;48;Lozère;15861;8275;7586;14886;20115;16512;9198;76572
2022;49;Maine-et-Loire;205012;104768;100244;189509;205615;142477;83201;825814
2022;50;Manche;105910;54556;51354;97664;125915;104324;59833;493646
2022;51;Marne;134156;68306;65850;138574;141572;99175;51547;565024
2022;52;Haute-Marne;34814;17959;16855;34445;42783;36189;20650;168881
2022;53;Mayenne;74436;38358;36078;62858;78582;56204;33639;305719
2022;54;Meurthe-et-Moselle;167853;86001;81852;185197;182518;127052;67773;730393
2022;55;Meuse;39230;20251;18979;37123;46186;37711;19376;179626
2022;56;Morbihan;167890;87176;80714;148022;199836;165900;91319;772967
2022;57;Moselle;231897;119225;112672;246513;278501;195422;98215;1050548
2022;58;Nièvre;37974;19452;18522;34950;49205;47841;29409;199379
2022;59;Nord;669638;342835;326803;665972;649527;416401;205627;2607165
2022;60;Oise;217040;110082;106958;193273;222004;135846;63566;831729
2022;61;Orne;58846;30693;28153;51880;68902;59175;35792;274595
2022;62;Pas-de-Calais;363483;186701;176782;332479;373320;261970;125336;1456588
2022;63;Puy-de-Dôme;148925;75300;73625;154943;170044;123117;69767;666796
2022;64;Pyrénées-Atlantiques;144169;74590;69579;143811;184255;137174;85250;694659
2022;65;Hautes-Pyrénées;45349;23747;21602;44901;58959;50145;31050;230404
2022;66;Pyrénées-Orientales;104312;53391;50921;94186;124651;102055;63175;488379
2022;67;Bas-Rhin;261617;133509;128108;293146;304864;199589;102561;1161777
2022;68;Haut-Rhin;174493;90261;84232;172261;208623;140417;72702;768496
2022;69;Rhône;478127;243837;234290;533360;466863;265641;164634;1908625
2022;70;Haute-Saône;52473;26984;25489;45431;62194;47976;24545;232619
2022;71;Saône-et-Loire;116910;60559;56351;104309;140320;115939;71048;548526
2022;72;Sarthe;135275;69706;65569;120024;144057;105646;62051;567053
2022;73;Savoie;102244;52981;49263;99237;119416;79699;44276;444872
2022;74;Haute-Savoie;209281;108481;100800;211357;234507;128343;69527;853015
2022;75;Paris;393712;197313;196399;704194;531569;308926;179301;2117702
2022;76;Seine-Maritime;300330;153947;146383;300350;308809;223287;121510;1254286
2022;77;Seine-et-Marne;389523;199466;190057;360526;385885;210359;98096;1444389
2022;78;Yvelines;386190;198355;187835;344940;394538;211766;119878;1457312
2022;79;Deux-Sèvres;84715;43836;40879;73551;99339;73706;42831;374142
2022;80;Somme;133870;68728;65142;134036;142448;101454;53470;565278
2022;81;Tarn;84364;43550;40814;75368;102436;79714;51554;393436
2022;82;Tarn-et-Garonne;63114;32627;30487;52867;70807;49506;28592;264886
2022;83;Var;224541;116539;108002;222508;279694;224340;150991;1102074
2022;84;Vaucluse;131359;67742;63617;118455;145742;105182;62577;563315
2022;85;Vendée;157694;81433;76261;133999;179800;148136;84492;704121
2022;86;Vienne;100948;51213;49735;103220;108025;80703;47972;440868
2022;87;Haute-Vienne;77196;39142;38054;79748;93072;74823;45887;370726
2022;88;Vosges;75879;39117;36762;70996;92972;76494;41523;357864
2022;89;Yonne;73506;37932;35574;64256;85612;68261;39382;331017
2022;90;Territoire de Belfort;32219;16703;15516;31863;35730;24537;13568;137917
2022;91;Essonne;352698;180640;172058;335155;343667;183079;97820;1312419
2022;92;Hauts-de-Seine;398146;203104;195042;457931;437983;219125;123905;1637090
2022;93;Seine-Saint-Denis;482107;246026;236081;472292;426987;204532;87727;1673645
2022;94;Val-de-Marne;358920;183473;175447;394535;369562;194560;102827;1420404
2022;95;Val-d'Oise;358589;183821;174768;328905;326706;174280;77991;1266471
2022;971;Guadeloupe;89217;45440;43777;72234;106454;74734;35837;378476
2022;972;Martinique;74848;37821;37027;67122;99158;74089;36988;352205
2022;973;Guyane;121973;60990;60983;81428;62769;23074;6814;296058
2022;974;La Réunion;253620;128616;125004;204152;238208;126022;47991;869993
2022;976;Mayotte;160766;79505;81261;79525;45866;10172;2693;299022
2023;01;Ain;170727;88293;82434;149960;183127;109363;58760;671937
2023;02;Aisne;125684;64688;60996;113454;132390;98737;52526;522791
2023;03;Allier;65821;33723;32098;62147;83062;72415;48998;332443
2023;04;Alpes-de-Haute-Provence;33829;17453;16376;31074;43060;36122;22569;166654
2023;05;Hautes-Alpes;28195;14610;13585;26275;36517;30877;18078;139942
2023;06;Alpes-Maritimes;232897;119198;113699;237498;287295;203675;148963;1110328
2023;07;Ardèche;70094;36318;33776;61742;87158;70314;42922;332230
2023;08;Ardennes;60733;31299;29434;55376;68630;52860;27818;265417
2023;09;Ariège;30938;15951;14987;29168;39975;33862;20638;154581
2023;10;Aube;76028;39466;36562;70172;76731;55908;33874;312713
2023;11;Aude;78891;40804;38087;71694;97098;80916;51176;379775
2023;12;Aveyron;54728;28267;26461;52359;71383;60413;40621;279504
2023;13;Bouches-du-Rhône;479084;245428;233656;491568;527142;350716;220608;2069118
2023;14;Calvados;160602;82723;77879;159523;172763;132798;74909;700595
2023;15;Cantal;27124;13761;13363;25546;37400;33086;20483;143639
2023;16;Charente;72094;37283;34811;69671;89892;74394;44985;351036
2023;17;Charente-Maritime;130134;67264;62870;123247;168391;150530;93602;665904
2023;18;Cher;61657;31581;30076;58379;74021;63615;39602;297274
2023;19;Corrèze;45967;24029;21938;44643;60149;52266;34052;237077
2023;21;Côte-d'Or;118593;60214;58379;130757;133149;96329;57338;536166
2023;22;Côtes-d'Armor;132020;67492;64528;112316;154041;130065;79392;607834
2023;23;Creuse;20194;10288;9906;18795;28721;28123;17273;113106
2023;24;Dordogne;75930;39272;36658;71425;104742;98395;60890;411382
2023;25;Doubs;133538;68242;65296;132459;138173;90978;54964;550112
2023;26;Drôme;121854;62740;59114;110832;134298;96727;59474;523185
2023;27;Eure;148744;75630;73114;126977;157983;108222;54784;596710
2023;28;Eure-et-Loir;106025;54589;51436;89256;113509;77332;42872;428994
2023;29;Finistère;198344;101939;96405;192902;237620;187803;109396;926065
2023;2A;Corse-du-Sud;33395;17203;16192;33264;45215;31582;20499;163955
2023;2B;Haute-Corse;36177;18773;17404;42927;49963;36206;22027;187300
2023;30;Gard;168202;86523;81679;153782;195819;150865;88767;757435
2023;31;Haute-Garonne;345935;175356;170579;410470;376818;213293;123851;1470367
2023;32;Gers;37938;19762;18176;33018;50510;43147;28207;192820
2023;33;Gironde;383613;194216;189397;426124;441875;277349;162476;1691437
2023;34;Hérault;279204;141584;137620;296912;305664;216240;134785;1232805
2023;35;Ille-et-Vilaine;275019;140546;134473;280111;286769;173226;103475;1118600
2023;36;Indre;41795;21350;20445;39054;54163;47959;31943;214914
2023;37;Indre-et-Loire;140660;72070;68590;142500;155727;110999;68130;618016
2023;38;Isère;321494;164916;156578;305761;337499;208839;120883;1294476
2023;39;Jura;55610;28360;27250;51233;67320;51014;31637;256814
2023;40;Landes;87180;45251;41929;79697;115466;91695;54631;428669
2023;41;Loir-et-Cher;72039;37154;34885;62216;83851;66643;41716;326465
2023;42;Loire;184494;95595;88899;169921;190728;137120;90079;772342
2023;43;Haute-Loire;48935;25329;23606;43467;59551;47197;27728;226878
2023;44;Loire-Atlantique;366108;187878;178230;370489;384727;240846;135143;1497313
2023;45;Loiret;170030;87868;82162;155434;173563;118062;69526;686615
2023;46;Lot;32291;16793;15498;29435;44213;42928;26441;175308
2023;47;Lot-et-Garonne;68922;35364;33558;62257;82480;69067;45583;328309
2023;48;Lozère;15833;8242;7591;14789;20043;16496;9487;76648
2023;49;Maine-et-Loire;203876;104103;99773;189238;205982;143062;86111;828269
2023;50;Manche;104856;53995;50861;97478;124502;104403;61403;492642
2023;51;Marne;133510;67851;65659;137618;141022;98390;53568;564108
2023;52;Haute-Marne;34006;17593;16413;34265;41984;35994;21295;167544
2023;53;Mayenne;73679;37989;35690;62892;78150;56087;34644;305452
2023;54;Meurthe-et-Moselle;166423;85393;81030;184253;182065;126567;70169;729477
2023;55;Meuse;38316;19768;18548;36624;45563;37415;20092;178010
2023;56;Morbihan;166951;86809;80142;148083;200127;166294;95928;777383
2023;57;Moselle;230567;118685;111882;245009;277466;197432;100982;1051456
2023;58;Nièvre;37424;19106;18318;34614;48548;46989;30282;197857
2023;59;Nord;663173;339508;323665;663901;649408;415646;214518;2606646
2023;60;Oise;215474;109159;106315;193427;221668;136484;66206;833259
2023;61;Orne;57865;30231;27634;51448;68035;58708;36816;272872
2023;62;Pas-de-Calais;359114;184394;174720;329976;372413;261967;130464;1453934
2023;63;Puy-de-Dôme;148812;75280;73532;155174;170398;122515;72218;669117
2023;64;Pyrénées-Atlantiques;143858;74622;69236;143895;183999;138172;87975;697899
2023;65;Hautes-Pyrénées;45112;23687;21425;45140;58712;50059;31560;230583
2023;66;Pyrénées-Orientales;103947;53226;50721;94374;124827;101841;65605;490594
2023;67;Bas-Rhin;262032;133664;128368;292820;305190;202364;106016;1168422
2023;68;Haut-Rhin;172907;89461;83446;171494;207843;142019;74968;769231
2023;69;Rhône;479113;244568;234545;534616;470912;265604;170769;1921014
2023;70;Haute-Saône;51637;26527;25110;45124;61781;47842;25389;231773
2023;71;Saône-et-Loire;115745;60029;55716;103840;139053;115474;73250;547362
2023;72;Sarthe;134287;69325;64962;119892;143551;105298;64090;567118
2023;73;Savoie;102566;53235;49331;99189;119792;80416;45834;447797
2023;74;Haute-Savoie;210461;109016;101445;212520;236605;129892;72789;862267
2023;75;Paris;387799;193986;193813;698264;526838;304526;185223;2102650
2023;76;Seine-Maritime;298776;153240;145536;298797;307993;222941;125697;1254204
2023;77;Seine-et-Marne;388321;198620;189701;361803;386845;211974;103832;1452775
2023;78;Yvelines;384935;198119;186816;345419;394725;211976;124469;1461524
2023;79;Deux-Sèvres;83748;43473;40275;73610;98844;73953;43744;373899
2023;80;Somme;132050;67791;64259;133775;141794;100983;55465;564067
2023;81;Tarn;83748;43266;40482;75507;102427;79813;53051;394546
2023;82;Tarn-et-Garonne;62905;32503;30402;53165;70883;49876;29210;266039
2023;83;Var;225381;117237;108144;222944;280198;224818;156919;1110260
2023;84;Vaucluse;130939;67627;63312;117629;145261;105014;64946;563789
2023;85;Vendée;156380;80860;75520;134432;180700;148997;88765;709274
2023;86;Vienne;100786;51175;49611;103207;108004;80247;49290;441534
2023;87;Haute-Vienne;76759;38928;37831;79565;92345;74235;47209;370113
2023;88;Vosges;74612;38457;36155;70190;91912;76143;43027;355884
2023;89;Yonne;72408;37390;35018;63727;85107;67694;40385;329321
2023;90;Territoire de Belfort;31679;16424;15255;31285;35644;24339;13944;136891
2023;91;Essonne;352220;180576;171644;335513;343204;183690;101426;1316053
2023;92;Hauts-de-Seine;395282;201800;193482;458773;439264;220666;128017;1642002
2023;93;Seine-Saint-Denis;481290;245649;235641;474891;429520;206409;90696;1682806
2023;94;Val-de-Marne;357823;182781;175042;396508;370026;195871;106520;1426748
2023;95;Val-d'Oise;359714;184301;175413;329763;327655;175610;81632;1274374
2023;971;Guadeloupe;86938;44307;42631;71299;103413;77129;37066;375845
2023;972;Martinique;72873;36839;36034;65757;95769;75832;37455;347686
2023;973;Guyane;122773;61420;61353;82967;64088;23919;7352;301099
2023;974;La Réunion;251904;127719;124185;203823;236340;130915;50120;873102
2023;976;Mayotte;166691;82436;84255;82450;47554;10545;2782;310022
